Index,Zip Code,Students Standard Exceeded_math2022,Students Standard Met_math2022,Students Standard Met and Above_math2022,Students Standard Nearly Met_math2022,Students Standard Not Met_math2022,Students with Scores_math2022,Percentage Standard Exceeded_math2022,Percentage Standard Met_math2022,Percentage Standard Met and Above_math2022,Percentage Standard Nearly Met_math2022,Percentage Standard Not Met_math2022,Median Mortgage
0,90001,430,787,1217,1439,3384,6040,7.119205298,13.02980132,20.14900662,23.82450331,56.02649007,425200
1,90002,144,304,448,661,1742,2851,5.050859348,10.66292529,15.71378464,23.18484742,61.10136794,411500
2,90003,427,900,1327,1689,3939,6955,6.139468009,12.9403307,19.07979871,24.28468728,56.63551402,430800
3,90004,611,611,1222,796,1338,3356,18.20619785,18.20619785,36.41239571,23.71871275,39.86889154,1148400
4,90005,487,749,1236,1137,2094,4467,10.90217148,16.76740542,27.6695769,25.45332438,46.87709872,964700
5,90006,116,245,361,486,1095,1942,5.973223481,12.61585994,18.58908342,25.02574665,56.38516993,716900
6,90007,327,671,998,1248,2745,4991,6.551793228,13.44419956,19.99599279,25.00500902,54.9989982,717300
7,90008,29,101,130,250,794,1174,2.470187394,8.60306644,11.07325383,21.29471891,67.63202726,781600
8,90010,23,57,80,135,318,533,4.315196998,10.69418386,15.00938086,25.32833021,59.66228893,822100
9,90011,367,1032,1399,2419,6036,9854,3.724375888,10.4729044,14.19728029,24.54840674,61.25431297,452100
10,90012,195,197,392,227,317,936,20.83333333,21.04700855,41.88034188,24.25213675,33.86752137,633000
11,90013,26,46,72,97,184,353,7.365439093,13.03116147,20.39660057,27.47875354,52.12464589,664800
12,90015,104,243,347,391,776,1514,6.869220608,16.05019815,22.91941876,25.82562748,51.25495376,715000
13,90016,130,289,419,597,1226,2242,5.798394291,12.89027654,18.68867083,26.6280107,54.68331847,677500
14,90017,55,193,248,464,1581,2293,2.398604448,8.416921064,10.81552551,20.23549935,68.94897514,697100
15,90018,179,339,518,730,1602,2850,6.280701754,11.89473684,18.1754386,25.61403509,56.21052632,704300
16,90019,274,372,646,577,1119,2342,11.69940222,15.88385995,27.58326217,24.63706234,47.77967549,1033900
17,90020,31,67,98,117,254,469,6.609808102,14.28571429,20.89552239,24.9466951,54.15778252,650300
18,90021,33,79,112,175,413,700,4.714285714,11.28571429,16,25,59,1013900
19,90022,414,853,1267,1509,2838,5614,7.37442109,15.19415746,22.56857855,26.8792305,50.55219095,471000
20,90023,468,828,1296,1390,2654,5340,8.764044944,15.50561798,24.26966292,26.02996255,49.70037453,479600
21,90024,314,187,501,151,209,861,36.46922184,21.71893148,58.18815331,17.53774681,24.27409988,1231000
22,90025,375,273,648,346,356,1350,27.77777778,20.22222222,48,25.62962963,26.37037037,905900
23,90026,243,507,750,934,1761,3445,7.053701016,14.71698113,21.77068215,27.11175617,51.11756168,962100
24,90027,202,193,395,172,242,809,24.96909765,23.8566131,48.82571075,21.26081582,29.91347342,1287200
25,90028,149,218,367,406,1007,1780,8.370786517,12.24719101,20.61797753,22.80898876,56.57303371,723000
26,90029,390,397,787,608,924,2319,16.81759379,17.11944804,33.93704183,26.2181975,39.84476067,898400
27,90031,207,386,593,561,1011,2165,9.561200924,17.82909931,27.39030023,25.91224018,46.69745958,616900
28,90032,298,436,734,658,1133,2525,11.8019802,17.26732673,29.06930693,26.05940594,44.87128713,605400
29,90033,229,462,691,758,1560,3009,7.610501828,15.35393819,22.96444001,25.19109339,51.8444666,538900
30,90034,592,431,1023,588,946,2557,23.1521314,16.85569026,40.00782167,22.99569808,36.99648025,1152500
31,90035,268,267,535,324,484,1343,19.9553239,19.88086374,39.83618764,24.12509308,36.03871929,1494600
32,90036,86,65,151,61,81,293,29.35153584,22.18430034,51.53583618,20.81911263,27.64505119,1634700
33,90037,195,395,590,778,1700,3068,6.355932203,12.87483703,19.23076923,25.35853977,55.410691,502000
34,90038,83,169,252,319,604,1175,7.063829787,14.38297872,21.44680851,27.14893617,51.40425532,945000
35,90039,155,178,333,164,154,651,23.80952381,27.34254992,51.15207373,25.19201229,23.65591398,972900
36,90040,33,71,104,161,349,614,5.374592834,11.56351792,16.93811075,26.22149837,56.84039088,452100
37,90041,489,425,914,468,632,2014,24.28003972,21.10228401,45.38232373,23.23733863,31.38033764,886800
38,90042,270,461,731,749,1179,2659,10.15419331,17.33734487,27.49153817,28.16848439,44.33997744,731600
39,90043,105,293,398,739,1992,3129,3.355704698,9.364014062,12.71971876,23.61776926,63.66251198,684500
40,90044,201,466,667,915,2990,4572,4.396325459,10.19247594,14.5888014,20.01312336,65.39807524,461200
41,90045,367,384,751,465,686,1902,19.29547844,20.18927445,39.48475289,24.44794953,36.06729758,1103500
42,90046,577,377,954,372,485,1811,31.86085036,20.81722805,52.67807841,20.54113749,26.7807841,1290400
43,90047,69,228,297,557,2053,2907,2.373581011,7.843137255,10.21671827,19.16064671,70.62263502,519400
44,90048,76,65,141,45,72,258,29.45736434,25.19379845,54.65116279,17.44186047,27.90697674,1441200
45,90049,799,537,1336,516,443,2295,34.81481481,23.39869281,58.21350763,22.48366013,19.30283224,2000000
46,90057,104,278,382,462,869,1713,6.071220082,16.2288383,22.30005838,26.97022767,50.72971395,576200
47,90058,21,23,44,45,118,207,10.14492754,11.11111111,21.25603865,21.73913043,57.00483092,419600
48,90059,142,314,456,667,1562,2685,5.288640596,11.69459963,16.98324022,24.84171322,58.17504655,415100
49,90061,81,272,353,611,1685,2649,3.057757644,10.26802567,13.32578331,23.06530766,63.60890902,438800
50,90062,96,125,221,351,1074,1646,5.832320778,7.594167679,13.42648846,21.32442284,65.2490887,550600
51,90063,635,1145,1780,2283,5326,9389,6.763233571,12.19512195,18.95835552,24.31568857,56.72595591,481100
52,90064,234,211,445,239,370,1054,22.20113852,20.01897533,42.22011385,22.67552182,35.10436433,1388300
53,90065,641,602,1243,893,1440,3576,17.92505593,16.8344519,34.75950783,24.97203579,40.26845638,833400
54,90066,671,714,1385,923,1329,3637,18.44927138,19.63156448,38.08083585,25.37805884,36.54110531,1282100
55,90068,16,20,36,23,10,69,23.1884058,28.98550725,52.17391304,33.33333333,14.49275362,1500800
56,90069,52,34,86,33,17,136,38.23529412,25,63.23529412,24.26470588,12.5,890100
57,90077,103,50,153,21,5,179,57.54189944,27.93296089,85.47486034,11.73184358,2.793296089,2000000
58,90094,81,52,133,42,20,195,41.53846154,26.66666667,68.20512821,21.53846154,10.25641026,1132000
59,90201,493,1098,1591,2107,4697,8395,5.87254318,13.07921382,18.951757,25.09827278,55.94997022,440500
60,90210,108,73,181,62,21,264,40.90909091,27.65151515,68.56060606,23.48484848,7.954545455,2000000
61,90211,118,86,204,75,35,314,37.57961783,27.38853503,64.96815287,23.88535032,11.14649682,2000000
62,90212,284,239,523,296,246,1065,26.66666667,22.44131455,49.10798122,27.79342723,23.09859155,2000000
63,90220,338,553,891,860,1805,3556,9.505061867,15.5511811,25.05624297,24.18447694,50.75928009,394900
64,90221,356,615,971,1049,2234,4254,8.368594264,14.45698166,22.82557593,24.65914433,52.51527974,412600
65,90222,287,407,694,592,927,2213,12.96882061,18.39132399,31.3601446,26.75101672,41.88883868,420700
66,90230,1010,724,1734,765,911,3410,29.61876833,21.23167155,50.85043988,22.4340176,26.71554252,849200
67,90232,145,120,265,132,133,530,27.35849057,22.64150943,50,24.90566038,25.09433962,1219100
68,90240,435,522,957,669,685,2311,18.82302034,22.58762441,41.41064474,28.94850714,29.64084812,646900
69,90241,498,795,1293,1158,2079,4530,10.99337748,17.54966887,28.54304636,25.56291391,45.89403974,627700
70,90242,487,814,1301,1367,1769,4437,10.97588461,18.3457291,29.3216137,30.80910525,39.86928105,557700
71,90245,706,476,1182,418,327,1927,36.63725999,24.70160872,61.33886871,21.69174883,16.96938246,1244200
72,90247,276,406,682,673,1443,2798,9.864188706,14.51036455,24.37455325,24.05289492,51.57255182,540800
73,90248,60,109,169,161,368,698,8.595988539,15.61604585,24.21203438,23.06590258,52.72206304,571200
74,90249,103,108,211,126,171,508,20.27559055,21.25984252,41.53543307,24.80314961,33.66141732,584000
75,90250,1006,1378,2384,1938,2861,7183,14.00529027,19.18418488,33.18947515,26.98037032,39.83015453,661400
76,90254,397,203,600,150,71,821,48.35566382,24.72594397,73.0816078,18.27040195,8.647990256,1674500
77,90255,605,1211,1816,2332,4959,9107,6.643241463,13.29746349,19.94070495,25.60667618,54.45261886,455000
78,90260,396,776,1172,1208,1850,4230,9.361702128,18.34515366,27.70685579,28.55791962,43.73522459,597300
79,90262,366,774,1140,1537,3542,6219,5.885190545,12.44573082,18.33092137,24.71458434,56.95449429,449600
80,90265,181,146,327,140,100,567,31.92239859,25.74955908,57.67195767,24.69135802,17.6366843,2000000
81,90266,1326,740,2066,484,273,2823,46.97130712,26.21324832,73.18455544,17.14488133,9.670563231,2000000
82,90270,158,314,472,496,886,1854,8.522114347,16.93635383,25.45846818,26.75296656,47.78856526,481800
83,90272,299,273,572,243,275,1090,27.43119266,25.04587156,52.47706422,22.29357798,25.2293578,2000000
84,90274,1027,597,1624,401,238,2263,45.38223597,26.3809103,71.76314627,17.71984092,10.51701281,1757700
85,90275,1824,991,2815,878,656,4349,41.94067602,22.78684755,64.72752357,20.18854909,15.08392734,1247000
86,90277,969,640,1609,498,384,2491,38.90004014,25.69249297,64.59253312,19.9919711,15.41549578,1143800
87,90278,968,670,1638,489,291,2418,40.03308519,27.70885029,67.74193548,20.22332506,12.03473945,992600
88,90280,705,1273,1978,2328,4542,8848,7.967902351,14.38743219,22.35533454,26.31103074,51.33363472,470200
89,90290,28,22,50,20,12,82,34.14634146,26.82926829,60.97560976,24.3902439,14.63414634,1184900
90,90291,220,156,376,142,188,706,31.16147309,22.09631728,53.25779037,20.11331445,26.62889518,1899800
91,90292,17,20,37,54,114,205,8.292682927,9.756097561,18.04878049,26.34146341,55.6097561,1076900
92,90293,10,23,33,37,39,109,9.174311927,21.10091743,30.27522936,33.94495413,35.77981651,899000
93,90301,99,266,365,629,1545,2539,3.899172903,10.47656558,14.37573848,24.77353289,60.85072863,547900
94,90302,182,317,499,466,682,1647,11.05039466,19.24711597,30.29751063,28.29386764,41.40862174,590000
95,90303,93,168,261,359,868,1488,6.25,11.29032258,17.54032258,24.12634409,58.33333333,606100
96,90304,203,496,699,1014,1272,2985,6.800670017,16.61641541,23.41708543,33.96984925,42.61306533,586600
97,90305,2,25,27,57,193,277,0.722021661,9.025270758,9.747292419,20.57761733,69.67509025,646500
98,90402,96,49,145,26,9,180,53.33333333,27.22222222,80.55555556,14.44444444,5,2000000
99,90403,684,363,1047,281,160,1488,45.96774194,24.39516129,70.36290323,18.8844086,10.75268817,1523400
100,90404,135,108,243,80,52,375,36,28.8,64.8,21.33333333,13.86666667,922900
101,90405,565,489,1054,506,556,2116,26.70132325,23.10964083,49.81096408,23.91304348,26.27599244,1430800
102,90501,404,466,870,474,591,1935,20.87855297,24.08268734,44.96124031,24.49612403,30.54263566,724900
103,90502,58,86,144,120,169,433,13.39491917,19.86143187,33.25635104,27.71362587,39.03002309,520700
104,90503,1304,912,2216,760,628,3604,36.18201998,25.30521643,61.4872364,21.08768036,17.42508324,861000
105,90504,778,571,1349,623,621,2593,30.00385654,22.0208253,52.02468184,24.02622445,23.94909371,712300
106,90505,1348,793,2141,602,424,3167,42.56394064,25.03946953,67.60341017,19.00852542,13.38806441,916100
107,90601,260,411,671,602,1012,2285,11.3785558,17.9868709,29.3654267,26.34573304,44.28884026,626500
108,90602,50,60,110,91,164,365,13.69863014,16.43835616,30.1369863,24.93150685,44.93150685,601600
109,90603,238,212,450,187,119,756,31.48148148,28.04232804,59.52380952,24.73544974,15.74074074,649600
110,90604,736,965,1701,1437,1549,4687,15.70300832,20.58886281,36.29187113,30.65927032,33.04885854,591400
111,90605,529,738,1267,1099,1529,3895,13.58151476,18.94736842,32.52888318,28.2156611,39.25545571,556000
112,90606,322,478,800,665,1007,2472,13.02588997,19.33656958,32.36245955,26.9012945,40.73624595,509600
113,90620,447,442,889,605,886,2380,18.78151261,18.57142857,37.35294118,25.42016807,37.22689076,622700
114,90621,331,393,724,535,811,2070,15.99033816,18.98550725,34.97584541,25.84541063,39.17874396,643200
115,90623,596,456,1052,504,666,2222,26.82268227,20.52205221,47.34473447,22.68226823,29.9729973,739200
116,90630,1744,969,2713,870,701,4284,40.70961718,22.61904762,63.3286648,20.30812325,16.36321195,700100
117,90631,529,841,1370,1179,1831,4380,12.07762557,19.20091324,31.27853881,26.91780822,41.80365297,628900
118,90638,510,645,1155,839,1043,3037,16.79288772,21.23806388,38.0309516,27.62594666,34.34310175,630100
119,90640,309,552,861,1161,3150,5172,5.974477958,10.67285383,16.64733179,22.44779582,60.90487239,558600
120,90650,543,1038,1581,1822,3090,6493,8.362852302,15.98644694,24.34929925,28.06098876,47.589712,487800
121,90660,297,623,920,1033,2045,3998,7.428714357,15.5827914,23.01150575,25.83791896,51.15057529,490300
122,90670,237,346,583,552,622,1757,13.48890154,19.69265794,33.18155948,31.41718839,35.40125213,492100
123,90680,43,71,114,103,158,375,11.46666667,18.93333333,30.4,27.46666667,42.13333333,472800
124,90701,193,258,451,426,477,1354,14.25406204,19.05465288,33.30871492,31.46233383,35.22895126,635000
125,90703,2448,1545,3993,1356,1241,6590,37.14719272,23.44461305,60.59180577,20.57663126,18.83156297,762700
126,90704,18,30,48,56,146,250,7.2,12,19.2,22.4,58.4,863800
127,90706,181,360,541,716,1440,2697,6.711160549,13.34816463,20.05932518,26.54801631,53.39265851,535300
128,90710,101,163,264,265,497,1026,9.844054581,15.88693957,25.73099415,25.82846004,48.44054581,523400
129,90712,231,391,622,623,948,2193,10.53351573,17.82945736,28.3629731,28.40857273,43.22845417,622800
130,90713,259,472,731,755,1266,2752,9.411337209,17.15116279,26.5625,27.43459302,46.00290698,638600
131,90715,97,191,288,346,563,1197,8.103592314,15.95655806,24.06015038,28.90559733,47.0342523,555400
132,90716,44,87,131,211,374,716,6.145251397,12.15083799,18.29608939,29.46927374,52.23463687,442000
133,90717,305,340,645,413,602,1660,18.37349398,20.48192771,38.85542169,24.87951807,36.26506024,649400
134,90720,1767,1174,2941,849,566,4356,40.56473829,26.9513315,67.51606979,19.49035813,12.99357208,1004200
135,90723,284,720,1004,1584,3101,5689,4.992089998,12.65600281,17.64809281,27.84320619,54.508701,411900
136,90731,369,580,949,896,1781,3626,10.17650303,15.99558742,26.17209046,24.71042471,49.11748483,657700
137,90732,165,149,314,177,166,657,25.11415525,22.67884323,47.79299848,26.94063927,25.26636225,657400
138,90740,121,121,242,57,26,325,37.23076923,37.23076923,74.46153846,17.53846154,8,442000
139,90744,422,680,1102,1175,2206,4483,9.413339282,15.16841401,24.58175329,26.21012715,49.20811956,471000
140,90745,562,785,1347,1251,1764,4362,12.88399817,17.99633196,30.88033012,28.67950481,40.44016506,516000
141,90746,113,245,358,391,666,1415,7.985865724,17.31448763,25.30035336,27.63250883,47.06713781,585600
142,90755,128,189,317,330,489,1136,11.26760563,16.63732394,27.90492958,29.04929577,43.04577465,553100
143,90802,141,218,359,457,852,1668,8.45323741,13.06954436,21.52278177,27.39808153,51.07913669,460300
144,90803,453,362,815,336,292,1443,31.39293139,25.08662509,56.47955648,23.28482328,20.23562024,943000
145,90804,200,403,603,748,1295,2646,7.558578987,15.23053666,22.78911565,28.26908541,48.94179894,541000
146,90805,385,764,1149,1550,2842,5541,6.948204295,13.78812489,20.73632918,27.97329002,51.2903808,469100
147,90806,207,328,535,492,730,1757,11.78144565,18.66818441,30.44963005,28.00227661,41.54809334,568400
148,90807,516,500,1016,602,807,2425,21.27835052,20.6185567,41.89690722,24.82474227,33.27835052,661100
149,90808,1188,1116,2304,1201,1029,4534,26.20202911,24.61402735,50.81605646,26.48875165,22.69519188,708300
150,90810,236,433,669,800,1556,3025,7.801652893,14.31404959,22.11570248,26.44628099,51.43801653,464500
151,90813,278,469,747,857,2039,3643,7.631073291,12.87400494,20.50507823,23.52456766,55.9703541,430500
152,90814,102,113,215,120,157,492,20.73170732,22.96747967,43.69918699,24.3902439,31.91056911,738900
153,90815,893,898,1791,1020,910,3721,23.99892502,24.1332975,48.13222252,27.41198603,24.45579145,701600
154,91001,271,280,551,397,730,1678,16.15017878,16.68653159,32.83671037,23.659118,43.50417163,887100
155,91006,1166,545,1711,510,572,2793,41.74722521,19.51306839,61.26029359,18.25993555,20.47977086,1074000
156,91007,980,573,1553,358,305,2216,44.22382671,25.85740072,70.08122744,16.15523466,13.76353791,1056600
157,91008,105,130,235,200,181,616,17.04545455,21.1038961,38.14935065,32.46753247,29.38311688,1414100
158,91010,148,260,408,351,558,1317,11.23766135,19.74183751,30.97949886,26.65148064,42.3690205,560900
159,91011,1266,471,1737,242,106,2085,60.71942446,22.58992806,83.30935252,11.60671463,5.083932854,1671000
160,91016,480,508,988,569,959,2516,19.07790143,20.19077901,39.26868045,22.61526232,38.11605723,707400
161,91024,335,219,554,169,148,871,38.46153846,25.1435132,63.60505166,19.40298507,16.99196326,1048300
162,91030,1317,507,1824,331,258,2413,54.57936179,21.01118939,75.59055118,13.71736428,10.69208454,1174400
163,91040,127,156,283,266,512,1061,11.96983977,14.70311027,26.67295005,25.07068803,48.25636192,638100
164,91042,74,126,200,168,315,683,10.83455344,18.44802343,29.28257687,24.59736457,46.12005857,617400
165,91101,52,58,110,126,346,582,8.934707904,9.965635739,18.90034364,21.64948454,59.45017182,615200
166,91103,99,113,212,212,590,1014,9.763313609,11.14398422,20.90729783,20.90729783,58.18540434,780200
167,91104,214,278,492,395,770,1657,12.91490646,16.77730839,29.69221485,23.83826192,46.46952323,836500
168,91105,31,45,76,49,64,189,16.4021164,23.80952381,40.21164021,25.92592593,33.86243386,1306200
169,91106,89,87,176,136,308,620,14.35483871,14.03225806,28.38709677,21.93548387,49.67741935,811200
170,91107,330,283,613,377,612,1602,20.59925094,17.66541823,38.26466916,23.53308365,38.20224719,913700
171,91108,850,272,1122,150,75,1347,63.10319228,20.19302153,83.29621381,11.13585746,5.567928731,2000000
172,91201,333,324,657,313,235,1205,27.63485477,26.8879668,54.52282158,25.97510373,19.50207469,916000
173,91202,369,395,764,449,604,1817,20.30820033,21.73913043,42.04733076,24.71106219,33.24160704,876700
174,91203,30,51,81,56,68,205,14.63414634,24.87804878,39.51219512,27.31707317,33.17073171,592600
175,91204,142,113,255,105,87,447,31.76733781,25.27964206,57.04697987,23.48993289,19.46308725,561800
176,91205,332,335,667,399,608,1674,19.83273596,20.01194743,39.84468339,23.83512545,36.32019116,677200
177,91206,506,520,1026,642,933,2601,19.45405613,19.99231065,39.44636678,24.6828143,35.87081892,910500
178,91208,226,196,422,184,90,696,32.47126437,28.16091954,60.63218391,26.43678161,12.93103448,1054700
179,91214,1714,1094,2808,772,613,4193,40.87765323,26.09110422,66.96875745,18.41163845,14.6196041,851700
180,91301,482,504,986,444,327,1757,27.43312464,28.68525896,56.11838361,25.27034718,18.61126921,871000
181,91302,755,745,1500,730,545,2775,27.20720721,26.84684685,54.05405405,26.30630631,19.63963964,1341400
182,91303,62,192,254,363,828,1445,4.290657439,13.28719723,17.57785467,25.12110727,57.30103806,536400
183,91304,185,232,417,399,735,1551,11.92778852,14.95809155,26.88588008,25.72533849,47.38878143,677700
184,91306,240,358,598,612,1317,2527,9.49742778,14.16699644,23.66442422,24.21844084,52.11713494,592400
185,91307,340,232,572,140,123,835,40.71856287,27.78443114,68.50299401,16.76646707,14.73053892,714600
186,91311,442,427,869,550,840,2259,19.56617973,18.9021691,38.46834883,24.34705622,37.18459495,679000
187,91316,184,137,321,91,84,496,37.09677419,27.62096774,64.71774194,18.34677419,16.93548387,724500
188,91320,910,660,1570,604,576,2750,33.09090909,24,57.09090909,21.96363636,20.94545455,755800
189,91321,566,752,1318,1005,1231,3554,15.9257175,21.15925718,37.08497468,28.27799662,34.6370287,513500
190,91324,701,655,1356,722,752,2830,24.77031802,23.14487633,47.91519435,25.51236749,26.57243816,680200
191,91325,663,535,1198,695,1124,3017,21.97547232,17.7328472,39.70831952,23.0361286,37.25555187,720900
192,91326,700,411,1111,275,189,1575,44.44444444,26.0952381,70.53968254,17.46031746,12,846700
193,91331,389,723,1112,1266,2849,5227,7.442127415,13.83202602,21.27415343,24.22039411,54.50545246,487600
194,91335,494,737,1231,1129,1754,4114,12.00777832,17.9144385,29.92221682,27.44287798,42.6349052,580500
195,91340,187,559,746,1182,2593,4521,4.136253041,12.36452112,16.50077417,26.14465826,57.35456757,515000
196,91342,466,960,1426,1498,2388,5312,8.772590361,18.07228916,26.84487952,28.2003012,44.95481928,520900
197,91343,495,682,1177,1116,2593,4886,10.13098649,13.95824806,24.08923455,22.84076955,53.06999591,608500
198,91344,1424,1536,2960,1802,2275,7037,20.23589598,21.8274833,42.06337928,25.6075032,32.32911752,690300
199,91345,67,60,127,68,134,329,20.36474164,18.23708207,38.60182371,20.66869301,40.72948328,558000
200,91350,860,875,1735,954,842,3531,24.3557066,24.78051543,49.13622203,27.01784197,23.845936,605800
201,91351,624,803,1427,1248,1331,4006,15.57663505,20.0449326,35.62156765,31.15327009,33.22516226,471900
202,91352,367,647,1014,1229,2764,5007,7.329738366,12.92190933,20.25164769,24.54563611,55.2027162,584100
203,91354,1087,843,1930,813,580,3323,32.71140536,25.36864279,58.08004815,24.46584412,17.45410773,648600
204,91355,767,632,1399,575,512,2486,30.85277554,25.42236525,56.27514079,23.12952534,20.59533387,600200
205,91356,685,390,1075,423,570,2068,33.1237911,18.85880077,51.98259188,20.45454545,27.56286267,1023000
206,91360,630,557,1187,578,639,2404,26.2063228,23.16971714,49.37603993,24.04326123,26.58069884,735100
207,91361,346,344,690,440,589,1719,20.12798138,20.01163467,40.13961606,25.59627691,34.26410704,1042900
208,91362,892,675,1567,568,594,2729,32.68596556,24.73433492,57.42030048,20.81348479,21.76621473,878300
209,91364,398,402,800,398,388,1586,25.09457755,25.34678436,50.44136192,25.09457755,24.46406053,949000
210,91367,836,864,1700,1058,1514,4272,19.56928839,20.2247191,39.79400749,24.7659176,35.44007491,786200
211,91377,963,569,1532,417,199,2148,44.83240223,26.48975791,71.32216015,19.41340782,9.26443203,823300
212,91381,1080,626,1706,460,293,2459,43.9202928,25.45750305,69.37779585,18.70679138,11.91541277,851300
213,91384,289,388,677,551,661,1889,15.29910005,20.53996824,35.83906829,29.16887242,34.99205929,579800
214,91387,341,436,777,550,706,2033,16.77324152,21.44613871,38.21938023,27.05361535,34.72700443,599500
215,91390,19,33,52,51,72,175,10.85714286,18.85714286,29.71428571,29.14285714,41.14285714,647600
216,91401,209,265,474,395,688,1557,13.42324984,17.01991008,30.44315992,25.36929994,44.18754014,798900
217,91402,244,447,691,781,1818,3290,7.416413374,13.58662614,21.00303951,23.73860182,55.25835866,483700
218,91403,104,102,206,102,105,413,25.18159806,24.69733656,49.87893462,24.69733656,25.42372881,1129100
219,91405,146,318,464,541,1392,2397,6.090947017,13.26658323,19.35753025,22.56987902,58.07259074,581600
220,91406,292,601,893,990,1736,3619,8.068527217,16.60679746,24.67532468,27.3556231,47.96905222,608600
221,91411,353,360,713,536,1141,2390,14.76987448,15.06276151,29.83263598,22.42677824,47.74058577,759300
222,91423,384,335,719,438,564,1721,22.31260895,19.46542708,41.77803603,25.45031958,32.77164439,1066600
223,91436,249,153,402,107,49,558,44.62365591,27.41935484,72.04301075,19.17562724,8.781362007,1545300
224,91501,168,196,364,163,141,668,25.1497006,29.34131737,54.49101796,24.4011976,21.10778443,827400
225,91502,88,102,190,125,170,485,18.1443299,21.03092784,39.17525773,25.77319588,35.05154639,761400
226,91504,496,448,944,512,466,1922,25.80645161,23.30905307,49.11550468,26.63891779,24.24557752,819100
227,91505,404,460,864,476,481,1821,22.1856123,25.26084569,47.44645799,26.1394838,26.41405821,812500
228,91506,374,471,845,564,694,2103,17.78411793,22.39657632,40.18069425,26.81883024,33.00047551,850600
229,91601,470,291,761,362,629,1752,26.82648402,16.60958904,43.43607306,20.66210046,35.90182648,744500
230,91602,423,295,718,356,521,1595,26.52037618,18.49529781,45.01567398,22.31974922,32.6645768,873700
231,91604,208,122,330,50,25,405,51.35802469,30.12345679,81.48148148,12.34567901,6.172839506,1263200
232,91605,171,374,545,661,1387,2593,6.594677979,14.42344774,21.01812572,25.49170845,53.49016583,605900
233,91606,242,356,598,536,1112,2246,10.7747106,15.85040071,26.62511131,23.86464826,49.51024043,648100
234,91607,165,135,300,71,67,438,37.67123288,30.82191781,68.49315068,16.21004566,15.29680365,864100
235,91701,859,1000,1859,1101,1045,4005,21.44818976,24.96878901,46.41697878,27.4906367,26.09238452,577200
236,91702,232,485,717,816,1606,3139,7.390888818,15.4507805,22.84166932,25.99553998,51.1627907,474100
237,91706,482,848,1330,1524,3250,6104,7.896461337,13.89252949,21.78899083,24.9672346,53.24377457,465900
238,91708,223,254,477,268,350,1095,20.3652968,23.19634703,43.56164384,24.47488584,31.96347032,488900
239,91709,2351,1590,3941,1443,1355,6739,34.88648167,23.59400505,58.48048672,21.4126725,20.10684078,676800
240,91710,654,998,1652,1570,2622,5844,11.19096509,17.07734428,28.26830938,26.86516085,44.86652977,512600
241,91711,754,747,1501,894,926,3321,22.70400482,22.49322493,45.19722975,26.91960253,27.88316772,714400
242,91722,241,367,608,648,1027,2283,10.55628559,16.07533947,26.63162505,28.38370565,44.98466929,513600
243,91723,261,435,696,749,1207,2652,9.841628959,16.40271493,26.24434389,28.2428356,45.51282051,579100
244,91724,250,346,596,482,624,1702,14.68860165,20.32902468,35.01762632,28.31962397,36.66274971,613400
245,91730,653,832,1485,1285,1768,4538,14.38959894,18.33406787,32.72366681,28.31643896,38.95989423,452400
246,91731,339,352,691,517,810,2018,16.7988107,17.44301288,34.24182359,25.61942517,40.13875124,497100
247,91732,549,701,1250,1390,3084,5724,9.591194969,12.24668064,21.83787561,24.28371768,53.87840671,517800
248,91733,214,357,571,516,840,1927,11.1053451,18.52620654,29.63155163,26.77737416,43.59107421,486400
249,91737,609,573,1182,557,487,2226,27.35849057,25.74123989,53.09973046,25.02246181,21.87780773,659500
250,91739,1921,1350,3271,1313,1188,5772,33.28135828,23.38877339,56.67013167,22.74774775,20.58212058,648400
251,91740,199,240,439,293,293,1025,19.41463415,23.41463415,42.82926829,28.58536585,28.58536585,590200
252,91741,709,720,1429,724,698,2851,24.8684672,25.25429674,50.12276394,25.39459839,24.48263767,757100
253,91744,381,907,1288,1634,2989,5911,6.44560988,15.34427339,21.78988327,27.64337676,50.56673998,463200
254,91745,1135,962,2097,1036,1357,4490,25.27839644,21.42538976,46.70378619,23.07349666,30.22271715,647300
255,91746,163,267,430,445,887,1762,9.250851305,15.15323496,24.40408627,25.2553916,50.34052213,488400
256,91748,581,484,1065,561,869,2495,23.28657315,19.3987976,42.68537074,22.48496994,34.82965932,663600
257,91750,313,317,630,232,186,1048,29.86641221,30.2480916,60.11450382,22.13740458,17.7480916,630400
258,91752,205,331,536,597,1119,2252,9.103019538,14.69804618,23.80106572,26.50976909,49.68916519,521900
259,91754,986,615,1601,549,531,2681,36.77732189,22.93920179,59.71652369,20.47743379,19.80604252,687700
260,91755,319,190,509,203,322,1034,30.85106383,18.37524178,49.22630561,19.63249516,31.14119923,639900
261,91759,6,14,20,19,12,51,11.76470588,27.45098039,39.21568627,37.25490196,23.52941176,380000
262,91761,513,782,1295,1247,1810,4352,11.78768382,17.96875,29.75643382,28.65349265,41.59007353,452900
263,91762,417,763,1180,1398,2595,5173,8.06108641,14.74966171,22.81074812,27.02493717,50.16431471,437700
264,91763,423,695,1118,1213,1784,4115,10.27946537,16.88942892,27.16889429,29.47752126,43.35358445,423700
265,91764,379,673,1052,1100,2135,4287,8.840681129,15.69862375,24.53930488,25.65896898,49.80172615,415600
266,91765,1722,992,2714,782,799,4295,40.09313155,23.09662398,63.18975553,18.20721769,18.60302678,709800
267,91766,323,619,942,1194,2555,4691,6.885525474,13.19548071,20.08100618,25.4529951,54.46599872,452700
268,91767,165,371,536,887,2116,3539,4.662333993,10.48318734,15.14552133,25.06357728,59.79090138,449500
269,91768,134,295,429,567,1162,2158,6.209453197,13.67006487,19.87951807,26.27432808,53.84615385,427500
270,91770,1197,811,2008,904,1234,4146,28.87120116,19.56102267,48.43222383,21.80414858,29.76362759,601300
271,91773,1057,932,1989,1040,831,3860,27.38341969,24.14507772,51.52849741,26.94300518,21.52849741,625400
272,91775,310,244,554,181,140,875,35.42857143,27.88571429,63.31428571,20.68571429,16,861400
273,91776,608,514,1122,588,809,2519,24.13656213,20.40492259,44.54148472,23.34259627,32.11591902,698900
274,91780,1016,587,1603,491,503,2597,39.12206392,22.60300347,61.72506739,18.9064305,19.36850212,766200
275,91784,396,388,784,396,294,1474,26.86567164,26.3229308,53.18860244,26.86567164,19.94572592,666800
276,91786,340,564,904,896,1360,3160,10.75949367,17.84810127,28.60759494,28.35443038,43.03797468,483400
277,91789,2064,1165,3229,1013,811,5053,40.84702157,23.05561053,63.9026321,20.04749654,16.04987136,790500
278,91790,579,625,1204,870,1283,3357,17.24754245,18.61781352,35.86535597,25.91599643,38.2186476,594000
279,91791,473,447,920,610,946,2476,19.10339257,18.05331179,37.15670436,24.6365105,38.20678514,647400
280,91792,96,167,263,340,632,1235,7.773279352,13.52226721,21.29554656,27.53036437,51.17408907,557100
281,91801,860,676,1536,717,1028,3281,26.21152088,20.60347455,46.81499543,21.85309357,31.331911,662100
282,91803,315,314,629,390,452,1471,21.41400408,21.34602311,42.76002719,26.51257648,30.72739633,643900
283,91901,119,231,350,313,404,1067,11.15276476,21.64948454,32.8022493,29.33458294,37.86316776,644200
284,91902,151,149,300,238,229,767,19.68709257,19.42633638,39.11342894,31.02998696,29.85658409,732000
285,91905,2,18,20,27,44,91,2.197802198,19.78021978,21.97802198,29.67032967,48.35164835,280400
286,91906,8,26,34,86,184,304,2.631578947,8.552631579,11.18421053,28.28947368,60.52631579,282800
287,91910,1312,1716,3028,2554,3558,9140,14.35448578,18.77461707,33.12910284,27.94310722,38.92778993,549100
288,91911,495,875,1370,1627,3216,6213,7.96716562,14.08337357,22.05053919,26.1870272,51.76243361,485300
289,91913,1133,1161,2294,1285,1306,4885,23.19344933,23.76663255,46.96008188,26.30501535,26.73490276,578600
290,91914,705,729,1434,735,704,2873,24.53880961,25.37417334,49.91298294,25.58301427,24.50400278,739300
291,91915,699,932,1631,959,866,3456,20.22569444,26.96759259,47.19328704,27.74884259,25.05787037,604600
292,91916,17,26,43,38,40,121,14.04958678,21.48760331,35.53719008,31.40495868,33.05785124,479600
293,91932,59,222,281,444,984,1709,3.452311293,12.99005266,16.44236396,25.98010532,57.57753072,639200
294,91935,30,70,100,113,221,434,6.912442396,16.12903226,23.04147465,26.03686636,50.92165899,681300
295,91941,484,633,1117,790,842,2749,17.60640233,23.02655511,40.63295744,28.73772281,30.62931975,684900
296,91942,499,508,1007,643,782,2432,20.51809211,20.88815789,41.40625,26.43914474,32.15460526,578600
297,91945,102,239,341,468,847,1656,6.15942029,14.43236715,20.59178744,28.26086957,51.147343,478800
298,91950,323,676,999,1447,2706,5152,6.269409938,13.12111801,19.39052795,28.08618012,52.52329193,450700
299,91962,17,34,51,92,192,335,5.074626866,10.14925373,15.2238806,27.46268657,57.31343284,433300
300,91963,4,25,29,44,134,207,1.93236715,12.07729469,14.00966184,21.25603865,64.73429952,350000
301,91977,469,625,1094,997,1772,3863,12.14082319,16.17913539,28.31995858,25.80895677,45.87108465,493000
302,91978,66,131,197,211,228,636,10.37735849,20.59748428,30.97484277,33.17610063,35.8490566,454100
303,92003,171,205,376,231,301,908,18.83259912,22.57709251,41.40969163,25.44052863,33.14977974,720300
304,92004,7,17,24,45,131,200,3.5,8.5,12,22.5,65.5,320600
305,92007,158,104,262,70,35,367,43.05177112,28.33787466,71.38964578,19.07356948,9.536784741,1304000
306,92008,944,851,1795,895,720,3410,27.68328446,24.95601173,52.63929619,26.24633431,21.1143695,881300
307,92009,1458,880,2338,586,256,3180,45.8490566,27.67295597,73.52201258,18.42767296,8.050314465,964200
308,92010,88,80,168,78,52,298,29.53020134,26.84563758,56.37583893,26.17449664,17.44966443,776000
309,92011,421,227,648,167,134,949,44.36248683,23.9199157,68.28240253,17.59747102,14.12012645,924700
310,92014,208,98,306,40,13,359,57.93871866,27.29805014,85.2367688,11.14206128,3.621169916,1827000
311,92019,606,916,1522,1325,2247,5094,11.89634865,17.98193954,29.87828818,26.01099333,44.11071849,576700
312,92020,739,885,1624,1423,2466,5513,13.40467985,16.05296572,29.45764557,25.81171776,44.73063668,576200
313,92021,274,452,726,859,1995,3580,7.653631285,12.62569832,20.27932961,23.99441341,55.72625698,469100
314,92024,1286,974,2260,828,722,3810,33.75328084,25.56430446,59.3175853,21.73228346,18.95013123,1063400
315,92025,709,905,1614,1218,1901,4733,14.97992816,19.12106486,34.10099303,25.73420663,40.16480034,558600
316,92026,375,645,1020,989,1986,3995,9.386733417,16.14518148,25.53191489,24.75594493,49.71214018,539900
317,92027,580,886,1466,1288,2136,4890,11.8609407,18.11860941,29.9795501,26.3394683,43.6809816,493300
318,92028,283,487,770,861,1256,2887,9.802563214,16.86872186,26.67128507,29.82334603,43.5053689,627900
319,92029,118,146,264,178,213,655,18.01526718,22.29007634,40.30534351,27.17557252,32.51908397,690900
320,92036,43,90,133,157,448,738,5.826558266,12.19512195,18.02168022,21.27371274,60.70460705,425900
321,92037,752,360,1112,272,185,1569,47.92861695,22.94455067,70.87316762,17.33588273,11.79094965,1614900
322,92040,371,636,1007,951,1241,3199,11.59737418,19.88121288,31.47858706,29.72804001,38.79337293,540200
323,92054,202,318,520,562,1045,2127,9.496944053,14.9506347,24.44757875,26.42219088,49.13023037,648800
324,92056,534,748,1282,1087,1368,3737,14.28953706,20.01605566,34.30559272,29.08750334,36.60690393,583700
325,92057,794,1076,1870,1542,2120,5532,14.35285611,19.45046999,33.8033261,27.87418655,38.32248735,530600
326,92058,282,489,771,752,913,2436,11.57635468,20.07389163,31.65024631,30.87027915,37.47947455,510400
327,92059,3,7,10,13,26,49,6.12244898,14.28571429,20.40816327,26.53061224,53.06122449,234200
328,92061,3,7,10,40,69,119,2.521008403,5.882352941,8.403361345,33.61344538,57.98319328,611500
329,92064,1959,2038,3997,2369,2550,8916,21.9717362,22.85778376,44.82951996,26.57021086,28.60026918,767500
330,92065,290,536,826,761,1014,2601,11.14955786,20.60745867,31.75701653,29.2579777,38.98500577,593100
331,92067,329,169,498,83,37,618,53.23624595,27.34627832,80.58252427,13.43042071,5.987055016,2000000
332,92069,814,993,1807,1206,1634,4647,17.51667743,21.36862492,38.88530235,25.95222724,35.16247041,569500
333,92070,4,9,13,4,3,20,20,45,65,20,15,335700
334,92071,923,1016,1939,1098,1122,4159,22.19283482,24.42894927,46.62178408,26.40057706,26.97763886,524100
335,92075,465,229,694,151,114,959,48.48800834,23.87904067,72.36704901,15.7455683,11.88738269,1442900
336,92078,1250,1210,2460,1333,1461,5254,23.79139703,23.03007233,46.82146936,25.37114579,27.80738485,665300
337,92081,110,147,257,182,230,669,16.44245142,21.97309417,38.41554559,27.20478326,34.37967115,599400
338,92082,82,180,262,397,1007,1666,4.921968788,10.80432173,15.72629052,23.82953181,60.44417767,620700
339,92083,523,744,1267,1126,1742,4135,12.64812576,17.99274486,30.64087062,27.23095526,42.12817412,467600
340,92084,297,404,701,739,1665,3105,9.565217391,13.01127214,22.57648953,23.80032206,53.62318841,600600
341,92086,4,13,17,26,67,110,3.636363636,11.81818182,15.45454545,23.63636364,60.90909091,265800
342,92101,50,139,189,225,540,954,5.241090147,14.57023061,19.81132075,23.58490566,56.60377358,626000
343,92102,367,616,983,1082,2058,4123,8.901285472,14.94057725,23.84186272,26.24302692,49.91511036,477100
344,92103,437,324,761,397,504,1662,26.29362214,19.49458484,45.78820698,23.88688327,30.32490975,835300
345,92104,161,157,318,141,120,579,27.80656304,27.11571675,54.92227979,24.35233161,20.7253886,679300
346,92105,235,479,714,986,2161,3861,6.086506087,12.40611241,18.49261849,25.53742554,55.96995597,459200
347,92106,355,460,815,728,865,2408,14.74252492,19.10299003,33.84551495,30.23255814,35.92192691,1070000
348,92107,374,243,617,218,203,1038,36.03082852,23.41040462,59.44123314,21.00192678,19.55684008,982300
349,92108,10,15,25,30,58,113,8.849557522,13.27433628,22.12389381,26.54867257,51.32743363,469300
350,92109,501,368,869,306,320,1495,33.51170569,24.61538462,58.1270903,20.46822742,21.40468227,962000
351,92110,385,373,758,379,411,1548,24.87080103,24.09560724,48.96640827,24.48320413,26.5503876,688800
352,92111,493,545,1038,747,1330,3115,15.82664526,17.49598716,33.32263242,23.98073836,42.69662921,604600
353,92113,106,315,421,777,2298,3496,3.032036613,9.010297483,12.0423341,22.22540046,65.73226545,406600
354,92114,421,681,1102,1094,1818,4014,10.48829098,16.96562033,27.45391131,27.25460887,45.29147982,461500
355,92115,321,543,864,905,1784,3553,9.034618632,15.28285956,24.31747819,25.47143259,50.21108922,580800
356,92116,129,158,287,202,255,744,17.33870968,21.23655914,38.57526882,27.15053763,34.27419355,690400
357,92117,432,515,947,720,1190,2857,15.12075604,18.0259013,33.14665733,25.20126006,41.6520826,690000
358,92118,499,416,915,307,188,1410,35.39007092,29.5035461,64.89361702,21.77304965,13.33333333,1656900
359,92119,434,396,830,375,276,1481,29.30452397,26.73869007,56.04321404,25.32072924,18.63605672,632500
360,92120,821,657,1478,667,647,2792,29.40544413,23.53151862,52.93696275,23.88968481,23.17335244,654100
361,92121,38,79,117,184,362,663,5.731523379,11.91553544,17.64705882,27.75263952,54.60030166,821100
362,92122,746,375,1121,364,452,1937,38.51316469,19.3598348,57.87299948,18.79194631,23.33505421,780000
363,92123,343,352,695,422,554,1671,20.52663076,21.0652304,41.59186116,25.25433872,33.15380012,600900
364,92124,482,575,1057,635,740,2432,19.81907895,23.64309211,43.46217105,26.11019737,30.42763158,704400
365,92126,1117,793,1910,866,901,3677,30.37802556,21.56649442,51.94451999,23.55180854,24.50367147,599500
366,92127,2590,1245,3835,813,445,5093,50.85411349,24.4453171,75.29943059,15.96308659,8.73748282,914200
367,92128,1198,751,1949,690,477,3116,38.44672657,24.10141207,62.54813864,22.14377407,15.30808729,681900
368,92129,2171,1157,3328,865,596,4789,45.33305492,24.15953226,69.49258718,18.06222593,12.44518689,815300
369,92130,3532,1154,4686,755,474,5915,59.7125951,19.50972105,79.22231615,12.76415892,8.013524937,1189300
370,92131,1651,710,2361,474,278,3113,53.03565692,22.80758111,75.84323803,15.22646964,8.930292323,885500
371,92139,246,382,628,649,925,2202,11.17166213,17.34786558,28.5195277,29.47320618,42.00726612,466100
372,92154,505,1004,1509,1835,3677,7021,7.192707592,14.29995727,21.49266486,26.13587808,52.37145706,477900
373,92173,114,234,348,521,1258,2127,5.359661495,11.00141044,16.36107193,24.49459332,59.14433474,388700
374,92201,355,742,1097,1463,3403,5963,5.953379172,12.44340097,18.39678014,24.53463022,57.06858964,272400
375,92203,116,224,340,387,810,1537,7.547169811,14.57384515,22.12101496,25.17891997,52.70006506,368900
376,92210,75,70,145,84,62,291,25.77319588,24.05498282,49.82817869,28.86597938,21.30584192,750700
377,92211,61,84,145,112,134,391,15.60102302,21.48337596,37.08439898,28.64450128,34.27109974,400000
378,92220,33,157,190,472,1387,2049,1.610541728,7.66227428,9.272816008,23.03562714,67.69155686,259600
379,92223,852,1472,2324,2175,3311,7810,10.90909091,18.84763124,29.75672215,27.84891165,42.3943662,354000
380,92225,57,136,193,299,922,1414,4.031117397,9.618104668,13.64922207,21.145686,65.20509194,165000
381,92227,213,489,702,843,1689,3234,6.586270872,15.12059369,21.70686456,26.06679035,52.22634508,226700
382,92230,3,24,27,34,91,152,1.973684211,15.78947368,17.76315789,22.36842105,59.86842105,211900
383,92231,186,466,652,1054,2756,4462,4.16853429,10.4437472,14.61228149,23.62169431,61.7660242,233300
384,92233,22,65,87,151,314,552,3.985507246,11.77536232,15.76086957,27.35507246,56.88405797,158400
385,92234,292,587,879,1001,2190,4070,7.174447174,14.42260442,21.5970516,24.59459459,53.80835381,325200
386,92236,266,574,840,1137,2545,4522,5.882352941,12.69349845,18.57585139,25.14374171,56.2804069,262300
387,92239,0,2,2,6,8,16,0,12.5,12.5,37.5,50,112500
388,92240,124,343,467,780,2120,3367,3.682803683,10.18711019,13.86991387,23.16602317,62.96406296,230300
389,92243,486,861,1347,1574,2693,5614,8.656929106,15.33665835,23.99358746,28.03705023,47.96936231,216700
390,92249,79,138,217,244,337,798,9.899749373,17.29323308,27.19298246,30.5764411,42.23057644,220200
391,92250,88,168,256,222,315,793,11.09709962,21.18537201,32.28247163,27.99495586,39.72257251,234300
392,92251,250,501,751,708,812,2271,11.00836636,22.06076618,33.06913254,31.17569353,35.75517393,271600
393,92252,32,46,78,87,141,306,10.45751634,15.03267974,25.49019608,28.43137255,46.07843137,217900
394,92253,222,406,628,764,1611,3003,7.392607393,13.51981352,20.91242091,25.44122544,53.64635365,453600
395,92254,39,114,153,231,583,967,4.033092037,11.78903826,15.8221303,23.88831437,60.28955533,160400
396,92256,13,15,28,28,24,80,16.25,18.75,35,35,30,183300
397,92257,3,5,8,13,11,32,9.375,15.625,25,40.625,34.375,57800
398,92260,474,579,1053,704,882,2639,17.961349,21.94012884,39.90147783,26.6767715,33.42175066,363400
399,92262,200,243,443,365,750,1558,12.83697047,15.59691913,28.4338896,23.42747112,48.13863928,447800
400,92264,116,177,293,330,503,1126,10.30195382,15.71936057,26.02131439,29.30728242,44.6714032,386800
401,92270,41,64,105,118,251,474,8.64978903,13.5021097,22.15189873,24.89451477,52.9535865,570400
402,92273,10,31,41,70,132,243,4.115226337,12.75720165,16.87242798,28.80658436,54.32098765,158800
403,92274,95,252,347,626,2145,3118,3.046824888,8.082103913,11.1289288,20.07697242,68.79409878,113200
404,92275,11,45,56,130,436,622,1.768488746,7.234726688,9.003215434,20.90032154,70.09646302,145600
405,92276,13,46,59,80,142,281,4.62633452,16.37010676,20.99644128,28.46975089,50.53380783,206000
406,92277,96,244,340,472,879,1691,5.677114134,14.42933176,20.10644589,27.91247782,51.98107629,158900
407,92281,5,16,21,60,160,241,2.074688797,6.639004149,8.713692946,24.89626556,66.39004149,160600
408,92284,62,170,232,360,939,1531,4.049640758,11.10385369,15.15349445,23.51404311,61.33246244,225100
409,92285,4,8,12,14,32,58,6.896551724,13.79310345,20.68965517,24.13793103,55.17241379,157100
410,92301,83,256,339,657,2019,3015,2.752902156,8.490878939,11.24378109,21.79104478,66.96517413,238600
411,92307,174,401,575,822,2163,3560,4.887640449,11.26404494,16.15168539,23.08988764,60.75842697,301700
412,92308,201,539,740,1070,2152,3962,5.073195356,13.60424028,18.67743564,27.00656234,54.31600202,282100
413,92309,0,6,6,15,34,55,0,10.90909091,10.90909091,27.27272727,61.81818182,86300
414,92311,88,263,351,643,2316,3310,2.658610272,7.945619335,10.60422961,19.42598187,69.96978852,144900
415,92313,126,233,359,481,1118,1958,6.435137896,11.89989785,18.33503575,24.56588355,57.09908069,378100
416,92314,30,50,80,88,161,329,9.118541033,15.19756839,24.31610942,26.74772036,48.93617021,307100
417,92315,69,123,192,208,302,702,9.829059829,17.52136752,27.35042735,29.62962963,43.01994302,467800
418,92316,153,383,536,836,2050,3422,4.47106955,11.19228521,15.66335476,24.4301578,59.90648743,339100
419,92320,97,139,236,183,178,597,16.2479062,23.28308208,39.53098827,30.65326633,29.81574539,279200
420,92324,305,755,1060,1553,3615,6228,4.897238279,12.1226718,17.01991008,24.93577392,58.04431599,326000
421,92325,7,27,34,66,148,248,2.822580645,10.88709677,13.70967742,26.61290323,59.67741935,278800
422,92327,4,9,13,14,30,57,7.01754386,15.78947368,22.80701754,24.56140351,52.63157895,151700
423,92335,344,983,1327,2113,5009,8449,4.07148775,11.63451296,15.70600071,25.00887679,59.2851225,344200
424,92336,1038,1547,2585,2580,4394,9559,10.85887645,16.18370122,27.04257768,26.99027095,45.96715138,460100
425,92337,215,561,776,1077,2490,4343,4.95049505,12.91733825,17.86783329,24.79852636,57.33364034,403600
426,92339,21,10,31,18,8,57,36.84210526,17.54385965,54.38596491,31.57894737,14.03508772,335700
427,92342,44,82,126,196,290,612,7.189542484,13.39869281,20.58823529,32.02614379,47.38562092,266100
428,92344,132,335,467,689,1508,2664,4.954954955,12.57507508,17.53003003,25.86336336,56.60660661,345700
429,92345,427,1055,1482,2495,6198,10175,4.196560197,10.36855037,14.56511057,24.52088452,60.91400491,277100
430,92346,448,805,1253,1546,3388,6187,7.240989171,13.01115242,20.25214159,24.98787781,54.7599806,367300
431,92352,63,158,221,319,575,1115,5.650224215,14.17040359,19.8206278,28.60986547,51.56950673,457800
432,92354,56,83,139,68,105,312,17.94871795,26.6025641,44.55128205,21.79487179,33.65384615,411400
433,92356,162,342,504,659,1294,2457,6.593406593,13.91941392,20.51282051,26.82132682,52.66585267,169100
434,92359,18,43,61,78,91,230,7.826086957,18.69565217,26.52173913,33.91304348,39.56521739,341600
435,92363,15,51,66,134,247,447,3.355704698,11.40939597,14.76510067,29.97762864,55.25727069,125400
436,92365,5,10,15,7,24,46,10.86956522,21.73913043,32.60869565,15.2173913,52.17391304,117600
437,92368,44,125,169,351,923,1443,3.049203049,8.662508663,11.71171171,24.32432432,63.96396396,259800
438,92371,105,238,343,442,929,1714,6.126021004,13.88564761,20.01166861,25.78763127,54.20070012,272700
439,92372,11,28,39,61,137,237,4.641350211,11.81434599,16.4556962,25.73839662,57.80590717,294100
440,92373,912,1063,1975,1366,1566,4907,18.58569391,21.66293051,40.24862441,27.83778276,31.91359283,530800
441,92374,769,991,1760,1328,2441,5529,13.90848255,17.92367517,31.83215771,24.01880991,44.14903237,413600
442,92376,277,759,1036,1720,4684,7440,3.72311828,10.2016129,13.92473118,23.11827957,62.95698925,332100
443,92377,219,359,578,781,1704,3063,7.149853085,11.72053542,18.87038851,25.4978779,55.63173359,418300
444,92391,0,0,0,21,122,143,0,0,0,14.68531469,85.31468531,277100
445,92392,353,621,974,1108,2870,4952,7.128432956,12.54038772,19.66882068,22.37479806,57.95638126,276900
446,92394,106,257,363,656,2221,3240,3.271604938,7.932098765,11.2037037,20.24691358,68.54938272,261300
447,92395,379,771,1150,1634,4976,7760,4.884020619,9.93556701,14.81958763,21.05670103,64.12371134,255100
448,92397,16,30,46,47,37,130,12.30769231,23.07692308,35.38461538,36.15384615,28.46153846,360900
449,92399,606,887,1493,1305,2084,4882,12.41294551,18.16878329,30.5817288,26.73084801,42.68742319,368400
450,92404,327,622,949,1301,3015,5265,6.210826211,11.81386515,18.02469136,24.71035138,57.26495726,289900
451,92405,103,304,407,659,1792,2858,3.603918824,10.63680896,14.24072778,23.05808258,62.70118964,277800
452,92407,469,948,1417,1661,3035,6113,7.672174055,15.50793391,23.18010797,27.1716015,49.64829053,367300
453,92408,84,166,250,489,1365,2104,3.992395437,7.88973384,11.88212928,23.24144487,64.87642586,304900
454,92410,373,512,885,991,2233,4109,9.077634461,12.46045266,21.53808713,24.11779022,54.34412266,207500
455,92411,119,327,446,659,1676,2781,4.279036318,11.7583603,16.03739662,23.69651205,60.26609133,238400
456,92501,185,327,512,582,1304,2398,7.714762302,13.63636364,21.35112594,24.27022519,54.37864887,358700
457,92503,665,1159,1824,2169,4259,8252,8.058652448,14.04507998,22.10373243,26.28453708,51.61173049,426000
458,92504,492,731,1223,1193,1893,4309,11.4179624,16.96449292,28.38245533,27.68623811,43.93130657,391600
459,92505,172,464,636,867,1963,3466,4.962492787,13.38718984,18.34968263,25.01442585,56.63589152,408100
460,92506,502,828,1330,1205,2219,4754,10.55952882,17.41691207,27.97644089,25.34707615,46.67648296,503700
461,92507,493,503,996,902,1717,3615,13.63762102,13.9142462,27.55186722,24.95159059,47.49654219,396100
462,92508,745,819,1564,826,910,3300,22.57575758,24.81818182,47.39393939,25.03030303,27.57575758,536600
463,92509,352,811,1163,1972,4855,7990,4.405506884,10.15018773,14.55569462,24.68085106,60.76345432,391900
464,92530,340,612,952,1196,3157,5305,6.409048068,11.53628652,17.94533459,22.54476909,59.50989632,368200
465,92532,398,623,1021,788,947,2756,14.44121916,22.60522496,37.04644412,28.59216255,34.36139332,413400
466,92536,5,17,22,38,49,109,4.587155963,15.59633028,20.18348624,34.86238532,44.95412844,374100
467,92539,9,33,42,90,191,323,2.786377709,10.21671827,13.00309598,27.86377709,59.13312693,242300
468,92543,221,425,646,967,2593,4206,5.254398478,10.10461246,15.35901094,22.99096529,61.65002378,169000
469,92544,121,401,522,784,2031,3337,3.626011387,12.01678154,15.64279293,23.49415643,60.86305064,271700
470,92545,135,290,425,640,1674,2739,4.928806134,10.58780577,15.5166119,23.36619204,61.11719606,252000
471,92549,21,36,57,58,55,170,12.35294118,21.17647059,33.52941176,34.11764706,32.35294118,400300
472,92551,258,495,753,1070,2228,4051,6.368797828,12.21920513,18.58800296,26.4132313,54.99876574,332400
473,92553,261,713,974,1652,4538,7164,3.64321608,9.95254048,13.59575656,23.05974316,63.34450028,321800
474,92555,197,466,663,1044,2185,3892,5.061664954,11.97327852,17.03494347,26.82425488,56.14080164,403300
475,92557,393,708,1101,1382,2590,5073,7.746895328,13.95623891,21.70313424,27.24226296,51.0546028,362200
476,92562,1142,1391,2533,1778,1908,6219,18.36308088,22.36694002,40.7300209,28.58980543,30.68017366,478500
477,92563,1272,1851,3123,2373,2030,7526,16.90140845,24.59473824,41.49614669,31.5306936,26.97315971,459800
478,92567,60,171,231,318,567,1116,5.376344086,15.32258065,20.69892473,28.49462366,50.80645161,379400
479,92570,178,541,719,1402,3749,5870,3.032367973,9.216354344,12.24872232,23.88415673,63.86712095,326200
480,92571,282,706,988,1362,3406,5756,4.89923558,12.26546213,17.16469771,23.66226546,59.17303683,336100
481,92582,43,159,202,397,1057,1656,2.596618357,9.601449275,12.19806763,23.97342995,63.82850242,339000
482,92583,244,580,824,1215,2624,4663,5.232682822,12.43834441,17.67102724,26.056187,56.27278576,251700
483,92584,617,1128,1745,1613,2040,5398,11.43015932,20.89662838,32.3267877,29.88143757,37.79177473,422000
484,92585,256,527,783,988,1776,3547,7.217366789,14.85762616,22.07499295,27.85452495,50.0704821,371400
485,92586,116,253,369,437,511,1317,8.807896735,19.2103265,28.01822323,33.18147304,38.80030372,276200
486,92587,30,55,85,54,85,224,13.39285714,24.55357143,37.94642857,24.10714286,37.94642857,442700
487,92590,531,864,1395,1459,2394,5248,10.11814024,16.46341463,26.58155488,27.80106707,45.61737805,1071800
488,92591,598,831,1429,1080,1098,3607,16.57887441,23.03853618,39.61741059,29.94177987,30.44080954,501600
489,92592,1585,1905,3490,2191,1935,7616,20.81144958,25.01313025,45.82457983,28.76838235,25.40703782,522400
490,92595,200,476,676,841,1531,3048,6.56167979,15.6167979,22.17847769,27.59186352,50.22965879,417300
491,92596,553,771,1324,1011,966,3301,16.75249924,23.35655862,40.10905786,30.6270827,29.26385944,475400
492,92602,1172,562,1734,406,316,2456,47.71986971,22.88273616,70.60260586,16.53094463,12.86644951,933600
493,92603,897,428,1325,241,125,1691,53.04553519,25.31046718,78.35600237,14.25192194,7.392075695,1303200
494,92604,1551,870,2421,671,586,3678,42.16965742,23.65415987,65.82381729,18.24361066,15.93257205,818400
495,92606,476,310,786,287,216,1289,36.92785105,24.04965089,60.97750194,22.26532196,16.75717611,853800
496,92612,726,328,1054,234,217,1505,48.23920266,21.79401993,70.03322259,15.54817276,14.41860465,789000
497,92614,590,412,1002,401,313,1716,34.38228438,24.00932401,58.39160839,23.36829837,18.24009324,789500
498,92618,1475,1043,2518,827,589,3934,37.49364514,26.51245552,64.00610066,21.0218607,14.97203864,960800
499,92620,3279,1492,4771,1067,685,6523,50.26828147,22.87291124,73.1411927,16.35750422,10.50130308,982000
500,92624,46,45,91,38,39,168,27.38095238,26.78571429,54.16666667,22.61904762,23.21428571,913400
501,92625,139,105,244,99,30,373,37.26541555,28.15013405,65.4155496,26.54155496,8.042895442,2000000
502,92626,565,607,1172,814,1020,3006,18.79574185,20.19294744,38.98868929,27.07917498,33.93213573,842500
503,92627,320,424,744,566,763,2073,15.43656536,20.45344911,35.89001447,27.30342499,36.80656054,842100
504,92629,122,125,247,157,186,590,20.6779661,21.18644068,41.86440678,26.61016949,31.52542373,981600
505,92630,1010,854,1864,942,1183,3989,25.31962898,21.4088744,46.72850338,23.61494109,29.65655553,694800
506,92646,1121,936,2057,734,443,3234,34.66295609,28.94248609,63.60544218,22.69635127,13.69820656,814900
507,92647,1311,965,2276,1096,1240,4612,28.42584562,20.92367736,49.34952298,23.76409367,26.88638335,793300
508,92648,769,632,1401,591,483,2475,31.07070707,25.53535354,56.60606061,23.87878788,19.51515152,985800
509,92649,339,362,701,395,383,1479,22.92089249,24.4759973,47.39688979,26.70723462,25.89587559,885000
510,92651,516,358,874,265,156,1295,39.84555985,27.64478764,67.49034749,20.46332046,12.04633205,2000000
511,92653,262,244,506,250,296,1052,24.90494297,23.19391635,48.09885932,23.76425856,28.13688213,771800
512,92655,191,193,384,201,155,740,25.81081081,26.08108108,51.89189189,27.16216216,20.94594595,583300
513,92656,1389,958,2347,811,630,3788,36.66842661,25.29039071,61.95881732,21.40971489,16.63146779,679300
514,92657,135,75,210,37,22,269,50.18587361,27.88104089,78.0669145,13.75464684,8.178438662,2000000
515,92660,594,447,1041,410,380,1831,32.44128891,24.41288913,56.85417804,22.39213545,20.75368651,1905400
516,92661,74,54,128,39,16,183,40.43715847,29.50819672,69.94535519,21.31147541,8.743169399,2000000
517,92663,484,361,845,362,482,1689,28.65600947,21.37359384,50.02960332,21.43280047,28.53759621,1590000
518,92672,390,432,822,442,475,1739,22.426682,24.84186314,47.26854514,25.41690627,27.31454859,980200
519,92673,920,804,1724,707,534,2965,31.02866779,27.1163575,58.1450253,23.84485666,18.01011804,972200
520,92675,667,910,1577,1315,2179,5071,13.15322422,17.94517847,31.09840268,25.93176888,42.96982844,770000
521,92677,875,716,1591,657,415,2663,32.85767931,26.88696958,59.74464889,24.67142321,15.5839279,909500
522,92678,12,14,26,10,4,40,30,35,65,25,10,777000
523,92679,330,258,588,177,86,851,38.77790834,30.3172738,69.09518214,20.79905993,10.10575793,970200
524,92683,1538,1216,2754,1346,1670,5770,26.65511265,21.0745234,47.72963605,23.32755633,28.94280763,651200
525,92688,1506,1101,2607,991,716,4314,34.90959666,25.52155772,60.43115438,22.97171998,16.59712564,673400
526,92691,1414,1226,2640,1138,1359,5137,27.52579326,23.86606969,51.39186296,22.15300759,26.45512945,750800
527,92692,1096,718,1814,651,509,2974,36.8527236,24.14256893,60.99529254,21.88971083,17.11499664,795500
528,92694,1266,807,2073,521,214,2808,45.08547009,28.73931624,73.82478632,18.55413105,7.621082621,844700
529,92701,683,914,1597,1514,2973,6084,11.226167,15.02301118,26.24917817,24.88494412,48.86587771,521700
530,92703,227,422,649,860,1876,3385,6.70605613,12.46676514,19.17282127,25.40620384,55.42097489,486000
531,92704,559,1110,1669,2013,3911,7593,7.362043988,14.61872778,21.98077176,26.51126037,51.50796787,534800
532,92705,973,982,1955,1150,1761,4866,19.99588985,20.18084669,40.17673654,23.63337443,36.18988903,914900
533,92706,330,502,832,1025,1550,3407,9.68594071,14.73437041,24.42031112,30.08511887,45.49457,673300
534,92707,245,588,833,1193,2549,4575,5.355191257,12.85245902,18.20765027,26.07650273,55.71584699,539700
535,92708,2016,1297,3313,1116,1111,5540,36.3898917,23.41155235,59.80144404,20.14440433,20.05415162,816900
536,92780,378,538,916,1032,2192,4140,9.130434783,12.99516908,22.12560386,24.92753623,52.9468599,669400
537,92782,788,573,1361,511,374,2246,35.08459484,25.51202137,60.59661621,22.75155833,16.65182547,879300
538,92801,359,609,968,1092,2213,4273,8.401591388,14.25228177,22.65387316,25.55581559,51.79031126,543200
539,92802,152,239,391,629,1497,2517,6.03893524,9.495431069,15.53436631,24.99006754,59.47556615,577500
540,92804,755,1075,1830,1766,3493,7089,10.65030329,15.16433912,25.8146424,24.91183524,49.27352236,594400
541,92805,299,627,926,1299,3168,5393,5.544223994,11.62618209,17.17040608,24.08677916,58.74281476,583800
542,92806,108,319,427,780,2034,3241,3.332304844,9.84264116,13.174946,24.0666461,62.7584079,623300
543,92807,985,693,1678,603,489,2770,35.55956679,25.01805054,60.57761733,21.76895307,17.6534296,731100
544,92808,546,467,1013,434,256,1703,32.0610687,27.42219612,59.48326483,25.48443922,15.03229595,807100
545,92821,1028,704,1732,649,609,2990,34.3812709,23.5451505,57.9264214,21.70568562,20.36789298,700900
546,92831,789,493,1282,573,931,2786,28.32017229,17.69562096,46.01579325,20.56712132,33.41708543,676300
547,92832,229,280,509,375,575,1459,15.69568197,19.19122687,34.88690884,25.70253598,39.41055517,615300
548,92833,1143,790,1933,944,1263,4140,27.60869565,19.0821256,46.69082126,22.80193237,30.50724638,686700
549,92835,560,340,900,300,191,1391,40.25880661,24.44284687,64.70165349,21.56721783,13.73112868,831100
550,92840,749,761,1510,1021,1334,3865,19.37904269,19.68952135,39.06856404,26.41655886,34.5148771,590900
551,92841,477,576,1053,722,1114,2889,16.51090343,19.9376947,36.44859813,24.99134649,38.56005538,609900
552,92843,887,798,1685,1093,1451,4229,20.97422559,18.86970915,39.84393474,25.84535351,34.31071175,570200
553,92844,782,574,1356,587,618,2561,30.53494729,22.41311988,52.94806716,22.92073409,24.13119875,545400
554,92845,796,534,1330,441,296,2067,38.50991776,25.83454282,64.34446057,21.33526851,14.32027092,668900
555,92860,404,622,1026,923,1294,3243,12.45760099,19.17977182,31.6373728,28.46130126,39.90132593,595300
556,92861,376,382,758,454,650,1862,20.19334049,20.51557465,40.70891515,24.38238453,34.90870032,1287100
557,92865,104,122,226,186,286,698,14.89971347,17.47851003,32.3782235,26.64756447,40.97421203,652400
558,92866,47,72,119,102,212,433,10.85450346,16.62817552,27.48267898,23.55658199,48.96073903,722200
559,92867,59,144,203,368,989,1560,3.782051282,9.230769231,13.01282051,23.58974359,63.3974359,780900
560,92868,74,123,197,303,501,1001,7.392607393,12.28771229,19.68031968,30.26973027,50.04995005,531900
561,92869,669,705,1374,1016,1405,3795,17.6284585,18.5770751,36.2055336,26.77206851,37.02239789,770700
562,92870,1727,1095,2822,1313,1851,5986,28.85065152,18.29268293,47.14333445,21.93451387,30.92215169,696700
563,92879,460,621,1081,920,1462,3463,13.28328039,17.93242853,31.21570892,26.56656079,42.21773029,452900
564,92880,1957,1786,3743,1898,2032,7673,25.50501759,23.27642382,48.78144142,24.73608758,26.482471,601700
565,92881,637,817,1454,826,1127,3407,18.6968007,23.98004109,42.6768418,24.24420311,33.07895509,615000
566,92882,803,1134,1937,1783,2670,6390,12.56651017,17.74647887,30.31298905,27.9029734,41.78403756,521000
567,92883,411,567,978,653,705,2336,17.59417808,24.27226027,41.86643836,27.95376712,30.17979452,538500
568,92886,1179,867,2046,722,533,3301,35.71644956,26.26476825,61.98121781,21.87215995,16.14662224,864700
569,92887,420,300,720,269,160,1149,36.5535248,26.10966057,62.66318538,23.41166232,13.92515231,903900
570,93001,401,419,820,599,1026,2445,16.400818,17.13701431,33.53783231,24.49897751,41.96319018,630400
571,93003,660,805,1465,1079,1593,4137,15.95358956,19.45854484,35.4121344,26.08170172,38.50616389,617700
572,93004,158,205,363,224,261,848,18.63207547,24.1745283,42.80660377,26.41509434,30.77830189,608100
573,93010,595,668,1263,907,1139,3309,17.98126322,20.18736778,38.16863101,27.41009368,34.42127531,662300
574,93012,620,486,1106,527,617,2250,27.55555556,21.6,49.15555556,23.42222222,27.42222222,657700
575,93013,156,190,346,273,341,960,16.25,19.79166667,36.04166667,28.4375,35.52083333,822400
576,93015,11,57,68,126,345,539,2.040816327,10.57513915,12.61595547,23.37662338,64.00742115,456600
577,93021,604,645,1249,733,903,2885,20.93587522,22.35701906,43.29289428,25.40727903,31.29982669,690900
578,93022,27,40,67,75,65,207,13.04347826,19.3236715,32.36714976,36.23188406,31.40096618,610500
579,93023,104,177,281,316,507,1104,9.420289855,16.0326087,25.45289855,28.62318841,45.92391304,692700
580,93030,207,649,856,1466,3695,6017,3.440252618,10.78610603,14.22635865,24.36430115,61.4093402,530000
581,93033,250,823,1073,2267,5864,9204,2.716210343,8.94176445,11.65797479,24.63059539,63.71142981,442700
582,93035,109,200,309,386,617,1312,8.307926829,15.24390244,23.55182927,29.42073171,47.02743902,632800
583,93036,302,649,951,1359,2872,5182,5.827865689,12.52412196,18.35198765,26.2253956,55.42261675,527700
584,93040,7,21,28,28,78,134,5.223880597,15.67164179,20.89552239,20.89552239,58.20895522,393500
585,93041,37,152,189,296,564,1049,3.527168732,14.48999047,18.0171592,28.21734986,53.76549094,446800
586,93060,142,347,489,724,1619,2832,5.014124294,12.25282486,17.26694915,25.56497175,57.1680791,446700
587,93063,417,604,1021,833,979,2833,14.71937875,21.32015531,36.03953406,29.40345923,34.55700671,626900
588,93065,1761,2458,4219,3742,5986,13947,12.62637126,17.62386176,30.25023303,26.83014268,42.91962429,642900
589,93066,84,116,200,145,171,516,16.27906977,22.48062016,38.75968992,28.10077519,33.13953488,1068500
590,93067,6,6,12,7,2,21,28.57142857,28.57142857,57.14285714,33.33333333,9.523809524,1875000
591,93101,101,174,275,298,513,1086,9.300184162,16.02209945,25.32228361,27.44014733,47.23756906,905500
592,93103,153,241,394,401,701,1496,10.22727273,16.10962567,26.3368984,26.80481283,46.85828877,1117000
593,93105,211,132,343,184,189,716,29.46927374,18.43575419,47.90502793,25.69832402,26.39664804,1180200
594,93108,240,63,303,25,6,334,71.85628743,18.86227545,90.71856287,7.48502994,1.796407186,2000000
595,93109,126,137,263,184,252,699,18.02575107,19.59942775,37.62517883,26.32331903,36.05150215,1413400
596,93110,432,425,857,438,530,1825,23.67123288,23.28767123,46.95890411,24,29.04109589,875700
597,93111,300,167,467,125,133,725,41.37931034,23.03448276,64.4137931,17.24137931,18.34482759,961100
598,93117,680,555,1235,549,703,2487,27.34217933,22.31604343,49.65822276,22.0747889,28.26698834,838300
599,93201,26,33,59,88,288,435,5.977011494,7.586206897,13.56321839,20.22988506,66.20689655,91000
600,93202,37,77,114,183,341,638,5.799373041,12.06896552,17.86833856,28.68338558,53.44827586,187500
601,93203,141,353,494,764,1932,3190,4.420062696,11.06583072,15.48589342,23.94984326,60.56426332,192800
602,93204,31,101,132,237,890,1259,2.462271644,8.022239873,10.48451152,18.82446386,70.69102462,180200
603,93206,5,19,24,59,135,218,2.293577982,8.71559633,11.00917431,27.06422018,61.9266055,152200
604,93210,47,136,183,335,1046,1564,3.00511509,8.695652174,11.70076726,21.41943734,66.8797954,203100
605,93212,56,191,247,410,1044,1701,3.29218107,11.22868901,14.52087008,24.10346855,61.37566138,176400
606,93215,543,1002,1545,1789,3000,6334,8.572781812,15.81938743,24.39216925,28.24439533,47.36343543,215100
607,93218,0,0,0,14,68,82,0,0,0,17.07317073,82.92682927,134500
608,93219,19,80,99,222,714,1035,1.835748792,7.729468599,9.565217391,21.44927536,68.98550725,162500
609,93221,119,197,316,342,672,1330,8.947368421,14.81203008,23.7593985,25.71428571,50.52631579,278600
610,93222,5,11,16,9,8,33,15.15151515,33.33333333,48.48484848,27.27272727,24.24242424,282500
611,93223,35,111,146,305,860,1311,2.669717773,8.466819222,11.13653699,23.26468345,65.59877956,189100
612,93224,8,16,24,17,8,49,16.32653061,32.65306122,48.97959184,34.69387755,16.32653061,152200
613,93230,708,1133,1841,1662,2424,5927,11.94533491,19.11591024,31.06124515,28.04116754,40.89758731,252300
614,93234,8,57,65,173,523,761,1.051248357,7.490144547,8.541392904,22.73324573,68.72536137,190000
615,93235,32,60,92,111,130,333,9.60960961,18.01801802,27.62762763,33.33333333,39.03903904,175600
616,93240,21,59,80,131,322,533,3.939962477,11.06941839,15.00938086,24.57786116,60.41275797,177900
617,93241,36,129,165,343,773,1281,2.81030445,10.07025761,12.88056206,26.77595628,60.34348165,147600
618,93242,4,22,26,78,242,346,1.156069364,6.358381503,7.514450867,22.5433526,69.94219653,264100
619,93243,14,39,53,100,212,365,3.835616438,10.68493151,14.52054795,27.39726027,58.08219178,359400
620,93244,32,38,70,75,86,231,13.85281385,16.45021645,30.3030303,32.46753247,37.22943723,177800
621,93245,611,823,1434,1050,1396,3880,15.74742268,21.21134021,36.95876289,27.06185567,35.97938144,261400
622,93247,128,315,443,588,1026,2057,6.222654351,15.31356344,21.53621779,28.58531842,49.87846378,208800
623,93249,47,88,135,116,177,428,10.98130841,20.56074766,31.54205607,27.10280374,41.35514019,149100
624,93250,96,232,328,510,1034,1872,5.128205128,12.39316239,17.52136752,27.24358974,55.23504274,203700
625,93252,641,947,1588,1498,2532,5618,11.40975436,16.85653257,28.26628693,26.66429334,45.06941972,151100
626,93254,14,19,33,29,72,134,10.44776119,14.17910448,24.62686567,21.64179104,53.73134328,182200
627,93256,23,86,109,156,333,598,3.846153846,14.3812709,18.22742475,26.08695652,55.68561873,162700
628,93257,806,1626,2432,2978,5485,10895,7.39788894,14.92427719,22.32216613,27.33363928,50.34419458,211800
629,93261,7,19,26,63,265,354,1.97740113,5.367231638,7.344632768,17.79661017,74.85875706,127600
630,93263,109,310,419,735,1648,2802,3.890078515,11.06352605,14.95360457,26.23126338,58.81513205,206700
631,93265,33,52,85,66,61,212,15.56603774,24.52830189,40.09433962,31.13207547,28.77358491,305900
632,93267,37,96,133,209,534,876,4.223744292,10.95890411,15.1826484,23.85844749,60.95890411,143000
633,93268,59,192,251,444,1022,1717,3.436225976,11.1822947,14.61852068,25.85905649,59.52242283,164200
634,93270,41,92,133,152,307,592,6.925675676,15.54054054,22.46621622,25.67567568,51.85810811,221700
635,93271,8,21,29,19,21,69,11.5942029,30.43478261,42.02898551,27.53623188,30.43478261,333600
636,93272,25,55,80,103,182,365,6.849315068,15.06849315,21.91780822,28.21917808,49.8630137,185200
637,93274,674,1335,2009,2526,4905,9440,7.139830508,14.14194915,21.28177966,26.75847458,51.95974576,246600
638,93277,424,752,1176,1480,2766,5422,7.819992623,13.86942088,21.6894135,27.29620066,51.01438584,256600
639,93280,139,351,490,811,1898,3199,4.345107846,10.97217881,15.31728665,25.3516724,59.33104095,188300
640,93283,23,28,51,55,79,185,12.43243243,15.13513514,27.56756757,29.72972973,42.7027027,119800
641,93286,44,109,153,250,689,1092,4.029304029,9.981684982,14.01098901,22.89377289,63.0952381,232800
642,93291,836,1219,2055,1768,2965,6788,12.3158515,17.95816146,30.27401296,26.04596346,43.68002357,294800
643,93292,212,448,660,910,1946,3516,6.029579067,12.74175199,18.77133106,25.88168373,55.34698521,252500
644,93301,150,274,424,472,1240,2136,7.02247191,12.82771536,19.85018727,22.09737828,58.05243446,190600
645,93304,188,465,653,1195,3403,5251,3.580270425,8.855456104,12.43572653,22.75756999,64.80670349,179300
646,93305,72,195,267,573,2178,3018,2.385685885,6.461232604,8.846918489,18.9860835,72.16699801,169300
647,93306,474,1146,1620,2407,6014,10041,4.720645354,11.41320586,16.13385121,23.97171596,59.89443283,227700
648,93307,519,1238,1757,2739,6797,11293,4.595767289,10.96254317,15.55831046,24.25396263,60.18772691,187100
649,93308,207,469,676,1050,2678,4404,4.70027248,10.64940963,15.34968211,23.84196185,60.80835604,242800
650,93309,322,667,989,1450,3437,5876,5.479918312,11.35125936,16.83117767,24.67665078,58.49217155,226200
651,93311,1019,1157,2176,1620,2348,6144,16.58528646,18.83138021,35.41666667,26.3671875,38.21614583,324800
652,93312,1383,1885,3268,2286,2375,7929,17.44230042,23.77348972,41.21579014,28.83087401,29.95333586,328400
653,93313,493,976,1469,1618,2437,5524,8.924692252,17.66835626,26.59304852,29.2903693,44.11658219,283400
654,93314,259,416,675,497,560,1732,14.95381062,24.01847575,38.97228637,28.69515012,32.33256351,412200
655,93401,352,274,626,207,207,1040,33.84615385,26.34615385,60.19230769,19.90384615,19.90384615,775100
656,93402,193,209,402,206,187,795,24.27672956,26.28930818,50.56603774,25.91194969,23.52201258,616100
657,93405,612,381,993,336,453,1782,34.34343434,21.38047138,55.72390572,18.85521886,25.42087542,753500
658,93420,375,456,831,678,871,2380,15.75630252,19.15966387,34.91596639,28.48739496,36.59663866,710000
659,93422,317,416,733,509,696,1938,16.35706914,21.46542828,37.82249742,26.26418989,35.91331269,573000
660,93426,0,8,8,11,12,31,0,25.80645161,25.80645161,35.48387097,38.70967742,446200
661,93427,46,82,128,107,139,374,12.29946524,21.92513369,34.22459893,28.60962567,37.1657754,621600
662,93428,26,41,67,70,112,249,10.44176707,16.46586345,26.90763052,28.1124498,44.97991968,705200
663,93430,32,36,68,23,21,112,28.57142857,32.14285714,60.71428571,20.53571429,18.75,896700
664,93432,2,8,10,9,8,27,7.407407407,29.62962963,37.03703704,33.33333333,29.62962963,657700
665,93433,68,115,183,203,262,648,10.49382716,17.74691358,28.24074074,31.32716049,40.43209877,577300
666,93434,24,81,105,229,530,864,2.777777778,9.375,12.15277778,26.50462963,61.34259259,337100
667,93436,191,442,633,903,1961,3497,5.461824421,12.6394052,18.10122963,25.82213326,56.07663712,373600
668,93440,4,24,28,31,67,126,3.174603175,19.04761905,22.22222222,24.6031746,53.17460317,553800
669,93441,31,28,59,23,19,101,30.69306931,27.72277228,58.41584158,22.77227723,18.81188119,927500
670,93442,47,83,130,86,90,306,15.35947712,27.12418301,42.48366013,28.10457516,29.41176471,711900
671,93444,83,189,272,296,497,1065,7.79342723,17.74647887,25.5399061,27.79342723,46.66666667,643200
672,93445,19,41,60,65,83,208,9.134615385,19.71153846,28.84615385,31.25,39.90384615,425200
673,93446,392,674,1066,977,1461,3504,11.18721461,19.23515982,30.42237443,27.88242009,41.69520548,502500
674,93449,112,157,269,152,201,622,18.00643087,25.24115756,43.24758842,24.43729904,32.31511254,771400
675,93450,1,4,5,22,26,53,1.886792453,7.547169811,9.433962264,41.50943396,49.05660377,338100
676,93451,30,57,87,84,118,289,10.38062284,19.72318339,30.10380623,29.06574394,40.83044983,427400
677,93453,31,37,68,27,18,113,27.43362832,32.74336283,60.17699115,23.89380531,15.92920354,504200
678,93454,236,760,996,1529,3275,5800,4.068965517,13.10344828,17.17241379,26.36206897,56.46551724,375900
679,93455,484,770,1254,1261,1990,4505,10.7436182,17.09211987,27.83573807,27.99112098,44.17314095,452600
680,93458,256,701,957,1474,3442,5873,4.3589307,11.93597821,16.29490891,25.09790567,58.60718542,361300
681,93460,61,77,138,106,125,369,16.53116531,20.86720867,37.39837398,28.72628726,33.87533875,962500
682,93461,2,8,10,35,100,145,1.379310345,5.517241379,6.896551724,24.13793103,68.96551724,346500
683,93463,135,91,226,101,78,405,33.33333333,22.4691358,55.80246914,24.9382716,19.25925926,892900
684,93465,182,238,420,348,318,1086,16.7587477,21.91528545,38.67403315,32.0441989,29.28176796,763200
685,93501,1,20,21,61,338,420,0.238095238,4.761904762,5,14.52380952,80.47619048,120300
686,93505,17,53,70,200,909,1179,1.441899915,4.49533503,5.937234945,16.96352841,77.09923664,169100
687,93510,318,431,749,688,1119,2556,12.44131455,16.86228482,29.30359937,26.9170579,43.77934272,589000
688,93513,6,19,25,28,44,97,6.18556701,19.58762887,25.77319588,28.86597938,45.36082474,269600
689,93514,139,183,322,275,351,948,14.66244726,19.30379747,33.96624473,29.00843882,37.02531646,337700
690,93516,7,27,34,58,147,239,2.928870293,11.29707113,14.22594142,24.26778243,61.50627615,74500
691,93517,3,10,13,10,2,25,12,40,52,40,8,254200
692,93518,1,9,10,6,21,37,2.702702703,24.32432432,27.02702703,16.21621622,56.75675676,235800
693,93523,63,99,162,185,237,584,10.78767123,16.95205479,27.73972603,31.67808219,40.58219178,81200
694,93526,0,6,6,12,13,31,0,19.35483871,19.35483871,38.70967742,41.93548387,223500
695,93527,8,12,20,21,31,72,11.11111111,16.66666667,27.77777778,29.16666667,43.05555556,212100
696,93532,8,22,30,37,28,95,8.421052632,23.15789474,31.57894737,38.94736842,29.47368421,318700
697,93534,65,184,249,621,2012,2882,2.25537821,6.384455239,8.639833449,21.54753643,69.81263012,257600
698,93535,227,617,844,1721,6378,8943,2.53829811,6.899250811,9.437548921,19.24410153,71.31834955,241800
699,93536,414,854,1268,1806,4109,7183,5.76360852,11.88918279,17.65279131,25.14269804,57.20451065,377300
700,93541,12,11,23,20,14,57,21.05263158,19.29824561,40.35087719,35.0877193,24.56140351,216300
701,93543,43,76,119,257,676,1052,4.087452471,7.224334601,11.31178707,24.42965779,64.25855513,266000
702,93545,10,30,40,60,50,150,6.666666667,20,26.66666667,40,33.33333333,197600
703,93546,64,91,155,172,214,541,11.82994455,16.8207024,28.65064695,31.79297597,39.55637708,493800
704,93550,195,612,807,1653,5584,8044,2.424167081,7.608155147,10.03232223,20.54947787,69.4181999,280900
705,93551,548,1058,1606,1780,2951,6337,8.647625059,16.69559729,25.34322234,28.0890011,46.56777655,410900
706,93552,193,499,692,979,2155,3826,5.044432828,13.04234187,18.0867747,25.58808155,56.32514375,324500
707,93553,16,44,60,59,135,254,6.299212598,17.32283465,23.62204724,23.22834646,53.1496063,288800
708,93555,239,386,625,694,1236,2555,9.354207436,15.10763209,24.46183953,27.16242661,48.37573386,194600
709,93560,55,177,232,416,1213,1861,2.955400322,9.511015583,12.46641591,22.35357335,65.18001075,240800
710,93561,147,299,446,567,1013,2026,7.255676209,14.75814413,22.01382034,27.98617966,50,295000
711,93562,3,12,15,26,54,95,3.157894737,12.63157895,15.78947368,27.36842105,56.84210526,57600
712,93591,34,129,163,240,577,980,3.469387755,13.16326531,16.63265306,24.48979592,58.87755102,207200
713,93601,11,39,50,68,61,179,6.145251397,21.7877095,27.93296089,37.98882682,34.07821229,327800
714,93602,4,21,25,16,13,54,7.407407407,38.88888889,46.2962963,29.62962963,24.07407407,291300
715,93605,5,4,9,5,7,21,23.80952381,19.04761905,42.85714286,23.80952381,33.33333333,297700
716,93608,7,13,20,37,58,115,6.086956522,11.30434783,17.39130435,32.17391304,50.43478261,154600
717,93609,98,145,243,240,406,889,11.02362205,16.31046119,27.33408324,26.99662542,45.66929134,206000
718,93610,118,306,424,528,975,1927,6.123508044,15.8796056,22.00311365,27.40010379,50.59678256,250600
719,93611,2151,2273,4424,2462,2419,9305,23.11660398,24.42772703,47.544331,26.45889307,25.99677593,365400
720,93612,461,532,993,780,912,2685,17.16945996,19.81378026,36.98324022,29.05027933,33.96648045,243900
721,93614,23,59,82,97,191,370,6.216216216,15.94594595,22.16216216,26.21621622,51.62162162,307300
722,93615,17,41,58,89,173,320,5.3125,12.8125,18.125,27.8125,54.0625,171900
723,93616,10,26,36,43,56,135,7.407407407,19.25925926,26.66666667,31.85185185,41.48148148,198000
724,93618,307,654,961,1079,1750,3790,8.100263852,17.25593668,25.35620053,28.46965699,46.17414248,237000
725,93619,669,478,1147,385,214,1746,38.3161512,27.3768614,65.6930126,22.05040092,12.25658648,452500
726,93620,40,118,158,256,710,1124,3.558718861,10.49822064,14.0569395,22.77580071,63.16725979,267700
727,93622,46,144,190,314,629,1133,4.060017652,12.70962048,16.76963813,27.71403354,55.51632833,185900
728,93625,154,232,386,337,527,1250,12.32,18.56,30.88,26.96,42.16,298100
729,93630,192,439,631,801,1301,2733,7.025246981,16.0629345,23.08818149,29.30845225,47.60336626,262200
730,93631,329,433,762,619,788,2169,15.16828031,19.96311664,35.13139696,28.538497,36.33010604,326800
731,93635,322,691,1013,1546,3263,5822,5.530745448,11.86877362,17.39951907,26.55444864,56.04603229,343000
732,93636,224,342,566,399,393,1358,16.49484536,25.18409426,41.67893962,29.3814433,28.93961708,375000
733,93637,215,593,808,1168,2864,4840,4.44214876,12.25206612,16.69421488,24.1322314,59.17355372,275900
734,93638,289,672,961,1553,3804,6318,4.574232352,10.6362773,15.21050965,24.58056347,60.20892688,239700
735,93640,110,261,371,520,1078,1969,5.586592179,13.25545962,18.8420518,26.40934485,54.74860335,204600
736,93643,9,15,24,39,71,134,6.71641791,11.19402985,17.91044776,29.10447761,52.98507463,237800
737,93644,38,113,151,220,321,692,5.49132948,16.32947977,21.82080925,31.79190751,46.38728324,301300
738,93646,123,236,359,379,583,1321,9.311127933,17.8652536,27.17638153,28.69038607,44.1332324,201700
739,93647,153,275,428,414,944,1786,8.566629339,15.39753639,23.96416573,23.18029115,52.85554311,167400
740,93648,121,216,337,448,1301,2086,5.800575264,10.35474593,16.15532119,21.47651007,62.36816874,186100
741,93650,53,114,167,168,194,529,10.01890359,21.55009452,31.56899811,31.75803403,36.67296786,192600
742,93651,40,76,116,111,91,318,12.57861635,23.89937107,36.47798742,34.90566038,28.6163522,366400
743,93652,1,17,18,37,139,194,0.515463918,8.762886598,9.278350515,19.07216495,71.64948454,169900
744,93653,7,11,18,17,11,46,15.2173913,23.91304348,39.13043478,36.95652174,23.91304348,443500
745,93654,452,647,1099,823,1126,3048,14.82939633,21.22703412,36.05643045,27.00131234,36.94225722,250200
746,93656,64,160,224,240,370,834,7.673860911,19.18465228,26.85851319,28.77697842,44.36450839,208200
747,93657,516,890,1406,1442,2266,5114,10.08994916,17.40320688,27.49315604,28.19710598,44.30973797,307100
748,93660,9,29,38,76,233,347,2.593659942,8.357348703,10.95100865,21.90201729,67.14697406,207900
749,93662,162,459,621,814,1641,3076,5.266579974,14.92197659,20.18855657,26.46293888,53.34850455,216900
750,93667,25,45,70,90,110,270,9.259259259,16.66666667,25.92592593,33.33333333,40.74074074,283300
751,93668,2,8,10,36,147,193,1.03626943,4.14507772,5.18134715,18.65284974,76.16580311,370600
752,93673,11,24,35,49,55,139,7.913669065,17.26618705,25.17985612,35.25179856,39.56834532,176100
753,93701,169,338,507,704,2146,3357,5.034256777,10.06851355,15.10277033,20.97110515,63.92612452,164100
754,93702,264,558,822,1026,2188,4036,6.541129832,13.82556987,20.3666997,25.42120912,54.21209118,159800
755,93703,141,324,465,628,1645,2738,5.149744339,11.83345508,16.98319942,22.93644996,60.08035062,183200
756,93704,345,662,1007,1226,2494,4727,7.29849799,14.00465411,21.3031521,25.9361117,52.7607362,291600
757,93705,138,317,455,675,1413,2543,5.426661424,12.46559182,17.89225324,26.54345262,55.56429414,213400
758,93706,560,846,1406,1575,3663,6644,8.428657435,12.7332932,21.16195063,23.70559904,55.13245033,186300
759,93710,100,279,379,514,993,1886,5.302226935,14.79321315,20.09544008,27.25344645,52.65111347,281800
760,93711,176,320,496,466,619,1581,11.13219481,20.24035421,31.37254902,29.47501581,39.15243517,398800
761,93720,1168,1083,2251,1047,875,4173,27.98945603,25.95255212,53.94200815,25.08986341,20.96812844,370800
762,93721,16,34,50,67,241,358,4.469273743,9.497206704,13.96648045,18.7150838,67.31843575,181500
763,93722,622,1068,1690,1759,2754,6203,10.02740609,17.21747542,27.24488151,28.35724649,44.397872,270900
764,93723,164,305,469,564,992,2025,8.098765432,15.0617284,23.16049383,27.85185185,48.98765432,374300
765,93725,217,435,652,739,1535,2926,7.416267943,14.86671224,22.28298018,25.25632262,52.4606972,226200
766,93726,546,772,1318,1356,3070,5744,9.505571031,13.44011142,22.94568245,23.60724234,53.44707521,214600
767,93727,578,1090,1668,1741,3227,6636,8.710066305,16.42555756,25.13562387,26.23568415,48.62869198,287000
768,93728,47,120,167,288,646,1101,4.268846503,10.89918256,15.16802906,26.15803815,58.67393279,210500
769,93730,803,541,1344,391,307,2042,39.32419197,26.49363369,65.81782566,19.14789422,15.03428012,522200
770,93737,64,120,184,97,85,366,17.4863388,32.78688525,50.27322404,26.50273224,23.22404372,387300
771,93901,232,501,733,926,1570,3229,7.184886962,15.51563952,22.70052648,28.67760917,48.62186435,569700
772,93905,356,938,1294,2011,4232,7537,4.723364734,12.44527,17.16863474,26.6817036,56.14966167,444400
773,93906,283,839,1122,1824,4116,7062,4.007363353,11.88048711,15.88785047,25.82837723,58.2837723,466900
774,93907,74,213,287,455,907,1649,4.487568223,12.91691935,17.40448757,27.59248029,55.00303214,566800
775,93908,180,215,395,250,186,831,21.66064982,25.87244284,47.53309266,30.08423586,22.38267148,846200
776,93920,3,4,7,6,8,21,14.28571429,19.04761905,33.33333333,28.57142857,38.0952381,1081500
777,93923,136,135,271,93,57,421,32.304038,32.06650831,64.37054632,22.09026128,13.5391924,1199000
778,93924,81,68,149,43,21,213,38.02816901,31.92488263,69.95305164,20.18779343,9.85915493,987100
779,93925,20,28,48,44,84,176,11.36363636,15.90909091,27.27272727,25,47.72727273,531300
780,93926,47,132,179,263,637,1079,4.355885079,12.23354958,16.58943466,24.37442076,59.03614458,453700
781,93927,73,263,336,608,1561,2505,2.914171657,10.499002,13.41317365,24.27145709,62.31536926,350400
782,93930,62,208,270,545,1215,2030,3.054187192,10.24630542,13.30049261,26.84729064,59.85221675,336200
783,93932,5,10,15,24,51,90,5.555555556,11.11111111,16.66666667,26.66666667,56.66666667,388100
784,93933,64,159,223,323,747,1293,4.949729312,12.29698376,17.24671307,24.98066512,57.77262181,599700
785,93940,205,296,501,426,590,1517,13.51351351,19.51219512,33.02570864,28.08174028,38.89255109,861000
786,93950,319,309,628,325,243,1196,26.6722408,25.8361204,52.5083612,27.17391304,20.31772575,929200
787,93954,2,6,8,10,32,50,4,12,16,20,64,230800
788,93955,142,302,444,654,1284,2382,5.961376994,12.67842149,18.63979849,27.4559194,53.90428212,588100
789,93960,114,315,429,633,1483,2545,4.479371316,12.37721022,16.85658153,24.87229862,58.27111984,432200
790,93962,49,100,149,85,78,312,15.70512821,32.05128205,47.75641026,27.24358974,25,562500
791,94002,1423,531,1954,356,268,2578,55.19782777,20.5973623,75.79519007,13.80915438,10.39565555,1678500
792,94005,84,53,137,52,31,220,38.18181818,24.09090909,62.27272727,23.63636364,14.09090909,923800
793,94010,1712,683,2395,509,425,3329,51.42685491,20.51667167,71.94352658,15.28987684,12.76659658,2000000
794,94014,185,317,502,507,866,1875,9.866666667,16.90666667,26.77333333,27.04,46.18666667,865400
795,94015,463,625,1088,769,962,2819,16.42426392,22.17098262,38.59524654,27.27917701,34.12557645,932200
796,94019,113,210,323,298,585,1206,9.369817579,17.41293532,26.7827529,24.70978441,48.50746269,1273400
797,94020,7,4,11,12,3,26,26.92307692,15.38461538,42.30769231,46.15384615,11.53846154,838200
798,94022,1430,376,1806,230,186,2222,64.35643564,16.92169217,81.27812781,10.3510351,8.370837084,2000000
799,94024,862,238,1100,102,44,1246,69.18138042,19.1011236,88.28250401,8.186195827,3.531300161,2000000
800,94025,1196,540,1736,568,959,3263,36.65338645,16.54918786,53.20257432,17.4072939,29.39013178,2000000
801,94027,444,219,663,137,198,998,44.48897796,21.94388778,66.43286573,13.72745491,19.83967936,2000000
802,94028,195,66,261,33,17,311,62.70096463,21.22186495,83.92282958,10.61093248,5.466237942,2000000
803,94030,573,316,889,256,254,1399,40.95782702,22.58756254,63.54538956,18.29878485,18.15582559,1606700
804,94037,25,34,59,23,12,94,26.59574468,36.17021277,62.76595745,24.46808511,12.76595745,1244300
805,94040,1058,336,1394,267,493,2154,49.11792015,15.59888579,64.71680594,12.39554318,22.88765088,2000000
806,94041,79,35,114,37,50,201,39.30348259,17.41293532,56.71641791,18.4079602,24.87562189,1804400
807,94043,464,231,695,208,252,1155,40.17316017,20,60.17316017,18.00865801,21.81818182,1341300
808,94044,462,522,984,512,483,1979,23.3451238,26.37695806,49.72208186,25.87165235,24.40626579,1012200
809,94060,6,25,31,42,42,115,5.217391304,21.73913043,26.95652174,36.52173913,36.52173913,1012800
810,94061,212,223,435,292,496,1223,17.33442355,18.23385119,35.56827473,23.87571545,40.55600981,1558300
811,94062,779,398,1177,408,586,2171,35.88208199,18.33256564,54.21464763,18.79318287,26.99216951,2000000
812,94063,122,193,315,431,940,1686,7.236061684,11.44721234,18.68327402,25.56346382,55.75326216,1002400
813,94065,319,139,458,104,98,660,48.33333333,21.06060606,69.39393939,15.75757576,14.84848485,1545800
814,94066,365,382,747,481,710,1938,18.83384933,19.71104231,38.54489164,24.81940144,36.63570691,1027400
815,94070,1029,430,1459,295,180,1934,53.20579111,22.23371251,75.43950362,15.25336091,9.307135471,1910300
816,94080,531,640,1171,896,1267,3334,15.92681464,19.19616077,35.1229754,26.87462507,38.00239952,963700
817,94085,129,126,255,209,477,941,13.7088204,13.39001063,27.09883103,22.21041445,50.69075452,1217000
818,94086,250,152,402,206,246,854,29.27400468,17.79859485,47.07259953,24.12177986,28.80562061,1504000
819,94087,2225,862,3087,722,913,4722,47.11986446,18.2549767,65.37484117,15.2901313,19.33502753,1945100
820,94089,203,144,347,174,216,737,27.54409769,19.53867028,47.08276798,23.60922659,29.30800543,338100
821,94102,8,21,29,27,94,150,5.333333333,14,19.33333333,18,62.66666667,968000
822,94103,22,40,62,92,317,471,4.670912951,8.492569002,13.16348195,19.5329087,67.30360934,960000
823,94107,82,69,151,75,221,447,18.34451902,15.43624161,33.78076063,16.77852349,49.44071588,1134600
824,94108,137,98,235,73,47,355,38.5915493,27.6056338,66.1971831,20.56338028,13.23943662,1129100
825,94109,131,154,285,157,232,674,19.43620178,22.84866469,42.28486647,23.29376855,34.42136499,1171200
826,94110,133,249,382,451,1066,1899,7.003686151,13.1121643,20.11585045,23.74934176,56.13480779,1233600
827,94111,1,2,3,17,19,39,2.564102564,5.128205128,7.692307692,43.58974359,48.71794872,1183200
828,94112,283,409,692,515,1116,2323,12.1825226,17.60654326,29.78906586,22.16960827,48.04132587,1022100
829,94114,194,249,443,432,1114,1989,9.753645048,12.5188537,22.27249874,21.71945701,56.00804424,1593400
830,94115,187,287,474,345,502,1321,14.15594247,21.72596518,35.88190765,26.11657835,38.001514,1515600
831,94116,724,570,1294,437,507,2238,32.35031278,25.4691689,57.81948168,19.52636282,22.6541555,1188000
832,94117,236,161,397,96,59,552,42.75362319,29.16666667,71.92028986,17.39130435,10.6884058,1478600
833,94118,318,267,585,229,170,984,32.31707317,27.13414634,59.45121951,23.27235772,17.27642276,1609400
834,94121,651,589,1240,443,354,2037,31.95876289,28.91507118,60.87383407,21.74766814,17.37849779,1506400
835,94122,931,633,1564,565,430,2559,36.38139898,24.73622509,61.11762407,22.07893708,16.80343884,1239600
836,94123,366,260,626,263,273,1162,31.49741824,22.37521515,53.87263339,22.63339071,23.4939759,2000000
837,94124,19,54,73,137,495,705,2.695035461,7.659574468,10.35460993,19.43262411,70.21276596,873900
838,94127,425,348,773,291,268,1332,31.90690691,26.12612613,58.03303303,21.84684685,20.12012012,1572100
839,94131,268,258,526,233,363,1122,23.885918,22.99465241,46.88057041,20.76648841,32.35294118,1458500
840,94132,502,212,714,135,121,970,51.75257732,21.8556701,73.60824742,13.91752577,12.4742268,1171000
841,94133,291,251,542,290,352,1184,24.5777027,21.19932432,45.77702703,24.49324324,29.72972973,1393700
842,94134,163,209,372,359,821,1552,10.50257732,13.46649485,23.96907216,23.1314433,52.89948454,925900
843,94301,320,115,435,71,51,557,57.45062837,20.64631957,78.09694794,12.74685817,9.156193896,2000000
844,94303,803,339,1142,432,1069,2643,30.38214151,12.82633371,43.20847522,16.34506243,40.44646235,1567000
845,94305,241,106,347,50,31,428,56.30841121,24.76635514,81.07476636,11.68224299,7.242990654,2000000
846,94306,1658,490,2148,324,212,2684,61.77347243,18.25633383,80.02980626,12.07153502,7.898658718,2000000
847,94401,344,140,484,155,260,899,38.2647386,15.57285873,53.83759733,17.24137931,28.92102336,944300
848,94402,669,447,1116,501,747,2364,28.29949239,18.90862944,47.20812183,21.1928934,31.59898477,1882300
849,94403,556,451,1007,573,1089,2669,20.8317722,16.8977145,37.7294867,21.46871487,40.80179843,1499300
850,94404,1020,385,1405,276,169,1850,55.13513514,20.81081081,75.94594595,14.91891892,9.135135135,1404600
851,94501,1230,1111,2341,1120,1190,4651,26.44592561,23.88733606,50.33326166,24.08084283,25.58589551,969500
852,94502,299,178,477,106,46,629,47.53577107,28.29888712,75.83465819,16.85214626,7.313195548,978600
853,94503,277,351,628,399,662,1689,16.40023683,20.78152753,37.18176436,23.62344583,39.19478982,557800
854,94505,74,111,185,109,114,408,18.1372549,27.20588235,45.34313725,26.71568627,27.94117647,674800
855,94506,847,422,1269,232,96,1597,53.03694427,26.42454602,79.46149029,14.52723857,6.011271133,1380000
856,94507,356,262,618,221,91,930,38.27956989,28.17204301,66.4516129,23.76344086,9.784946237,1799100
857,94508,5,11,16,24,23,63,7.936507937,17.46031746,25.3968254,38.0952381,36.50793651,684400
858,94509,150,391,541,979,2911,4431,3.385240352,8.824193184,12.20943354,22.09433536,65.6962311,435600
859,94510,446,554,1000,567,607,2174,20.51517939,25.48298068,45.99816007,26.08095676,27.92088316,628300
860,94513,1165,1766,2931,2181,2383,7495,15.5436958,23.56237492,39.10607071,29.0993996,31.79452969,635600
861,94514,56,81,137,136,175,448,12.5,18.08035714,30.58035714,30.35714286,39.0625,711000
862,94515,38,83,121,148,164,433,8.775981524,19.16859122,27.94457275,34.18013857,37.87528868,731200
863,94516,11,18,29,11,9,49,22.44897959,36.73469388,59.18367347,22.44897959,18.36734694,685500
864,94517,207,227,434,214,198,846,24.46808511,26.8321513,51.30023641,25.29550827,23.40425532,815600
865,94518,57,149,206,300,933,1439,3.961084086,10.35441279,14.31549687,20.84781098,64.83669215,649100
866,94519,110,119,229,185,296,710,15.49295775,16.76056338,32.25352113,26.05633803,41.69014085,608400
867,94520,81,164,245,352,810,1407,5.756929638,11.65600569,17.41293532,25.0177683,57.56929638,480300
868,94521,350,512,862,758,1286,2906,12.0440468,17.61871989,29.66276669,26.08396421,44.2532691,649100
869,94523,765,782,1547,892,992,3431,22.2967065,22.79218887,45.08889537,25.99825124,28.9128534,827200
870,94525,15,41,56,84,204,344,4.360465116,11.91860465,16.27906977,24.41860465,59.30232558,591000
871,94526,1162,979,2141,709,406,3256,35.68796069,30.06756757,65.75552826,21.77518428,12.46928747,1265000
872,94530,336,393,729,453,902,2084,16.12284069,18.85796545,34.98080614,21.73704415,43.28214971,891700
873,94531,145,362,507,781,1944,3232,4.486386139,11.20049505,15.68688119,24.16460396,60.14851485,528200
874,94533,531,935,1466,1697,3677,6840,7.763157895,13.66959064,21.43274854,24.80994152,53.75730994,393700
875,94534,770,855,1625,1027,1167,3819,20.16234616,22.3880597,42.55040587,26.89185651,30.55773763,589000
876,94536,2905,1229,4134,1089,1216,6439,45.1157012,19.08681472,64.20251592,16.91256406,18.88492002,989600
877,94538,2417,1026,3443,973,1353,5769,41.89634252,17.78471139,59.68105391,16.86600797,23.45293812,888400
878,94539,2850,687,3537,288,187,4012,71.03688933,17.12362911,88.16051844,7.178464606,4.661016949,1548800
879,94541,223,456,679,833,1933,3445,6.473149492,13.23657475,19.70972424,24.17997097,56.11030479,641200
880,94542,56,87,143,91,106,340,16.47058824,25.58823529,42.05882353,26.76470588,31.17647059,884200
881,94544,95,222,317,483,1535,2335,4.068522484,9.507494647,13.57601713,20.68522484,65.73875803,624800
882,94545,321,480,801,824,1531,3156,10.17110266,15.20912548,25.38022814,26.10899873,48.51077313,664400
883,94546,983,720,1703,655,669,3027,32.47439709,23.78592666,56.26032375,21.63858606,22.10109019,811300
884,94547,197,276,473,351,490,1314,14.99238965,21.00456621,35.99695586,26.71232877,37.29071537,590800
885,94548,18,40,58,72,67,197,9.137055838,20.30456853,29.44162437,36.54822335,34.01015228,817500
886,94549,1288,592,1880,380,148,2408,53.48837209,24.58471761,78.0730897,15.7807309,6.146179402,1547800
887,94550,1062,899,1961,919,1068,3948,26.89969605,22.7710233,49.67071935,23.27760892,27.05167173,925400
888,94551,517,493,1010,623,710,2343,22.0657277,21.04139991,43.10712761,26.58984208,30.3030303,774200
889,94552,546,396,942,401,379,1722,31.70731707,22.99651568,54.70383275,23.28687573,22.00929152,1056100
890,94553,393,513,906,592,668,2166,18.14404432,23.68421053,41.82825485,27.33148661,30.84025854,628400
891,94555,894,287,1181,145,112,1438,62.16968011,19.95827538,82.12795549,10.08344924,7.788595271,1078400
892,94556,740,399,1139,261,109,1509,49.03909874,26.44135189,75.48045063,17.29622266,7.223326706,1224100
893,94558,540,924,1464,1423,2740,5627,9.59658788,16.42082815,26.01741603,25.28878621,48.69379776,693700
894,94559,39,99,138,180,359,677,5.76070901,14.62333826,20.38404727,26.58788774,53.02806499,704900
895,94560,448,455,903,596,917,2416,18.54304636,18.83278146,37.37582781,24.66887417,37.95529801,870200
896,94561,256,633,889,1193,2133,4215,6.073546856,15.01779359,21.09134045,28.30367734,50.60498221,501200
897,94563,971,465,1436,317,104,1857,52.28863759,25.04038772,77.32902531,17.07054389,5.600430802,1539900
898,94564,122,200,322,437,736,1495,8.160535117,13.37792642,21.53846154,29.23076923,49.23076923,590900
899,94565,281,763,1044,1664,4238,6946,4.045493809,10.98473942,15.03023323,23.9562338,61.01353297,442300
900,94566,2062,967,3029,697,506,4232,48.72400756,22.84971645,71.57372401,16.46975425,11.95652174,1195200
901,94567,1,6,7,9,18,34,2.941176471,17.64705882,20.58823529,26.47058824,52.94117647,383300
902,94568,3365,1555,4920,991,716,6627,50.77712389,23.46461446,74.24173834,14.95397616,10.8042855,983000
903,94571,41,61,102,138,195,435,9.425287356,14.02298851,23.44827586,31.72413793,44.82758621,398900
904,94572,12,36,48,74,144,266,4.511278195,13.53383459,18.04511278,27.81954887,54.13533835,546400
905,94574,100,126,226,189,168,583,17.15265866,21.61234991,38.76500858,32.41852487,28.81646655,1295900
906,94577,284,488,772,826,1662,3260,8.711656442,14.96932515,23.6809816,25.33742331,50.98159509,667600
907,94578,37,92,129,162,314,605,6.115702479,15.20661157,21.32231405,26.7768595,51.90082645,633500
908,94579,157,231,388,320,459,1167,13.45329906,19.79434447,33.24764353,27.42073693,39.33161954,659600
909,94580,307,433,740,752,1616,3108,9.877734878,13.93178893,23.80952381,24.1956242,51.99485199,649600
910,94582,3020,1136,4156,714,411,5281,57.18613899,21.51107745,78.69721644,13.52016664,7.782616929,1153600
911,94583,1697,1092,2789,862,510,4161,40.78346551,26.24369142,67.02715693,20.716174,12.25666907,987300
912,94585,87,206,293,383,886,1562,5.56978233,13.18822023,18.75800256,24.51984635,56.72215109,419200
913,94586,90,53,143,25,11,179,50.27932961,29.60893855,79.88826816,13.96648045,6.145251397,1166700
914,94587,896,1007,1903,1243,1881,5027,17.82375174,20.03182813,37.85557987,24.72647702,37.41794311,860300
915,94588,1567,685,2252,429,262,2943,53.24498811,23.27556915,76.52055725,14.57696228,8.902480462,1050600
916,94589,226,416,642,782,1710,3134,7.211231653,13.27377154,20.48500319,24.95213784,54.56285897,372000
917,94590,76,155,231,382,856,1469,5.173587474,10.55139551,15.72498298,26.00408441,58.27093261,381400
918,94591,183,362,545,621,1363,2529,7.236061684,14.31395809,21.55001977,24.55516014,53.89482009,482700
919,94592,4,24,28,46,194,268,1.492537313,8.955223881,10.44776119,17.1641791,72.3880597,653700
920,94595,209,128,337,91,41,469,44.56289979,27.29211087,71.85501066,19.40298507,8.742004264,673500
921,94596,262,198,460,134,122,716,36.59217877,27.65363128,64.24581006,18.7150838,17.03910615,1081800
922,94597,439,282,721,281,206,1208,36.3410596,23.34437086,59.68543046,23.2615894,17.05298013,806800
923,94598,756,640,1396,608,478,2482,30.45930701,25.78565673,56.24496374,24.49637389,19.25866237,1050800
924,94601,139,358,497,756,2240,3493,3.979387346,10.24906957,14.22845691,21.64328657,64.12825651,581800
925,94602,136,132,268,190,459,917,14.83097056,14.39476554,29.2257361,20.71973828,50.05452563,919900
926,94603,61,197,258,573,1912,2743,2.223842508,7.181917608,9.405760117,20.889537,69.70470288,447000
927,94605,111,199,310,492,1469,2271,4.887714663,8.762659621,13.65037428,21.66446499,64.68516072,695000
928,94606,287,301,588,471,796,1855,15.47169811,16.22641509,31.69811321,25.39083558,42.91105121,643100
929,94607,408,320,728,436,691,1855,21.99460916,17.25067385,39.24528302,23.50404313,37.25067385,640800
930,94608,305,180,485,289,663,1437,21.22477383,12.52609603,33.75086987,20.11134308,46.13778706,691300
931,94609,85,73,158,96,173,427,19.90632319,17.09601874,37.00234192,22.4824356,40.51522248,937000
932,94610,353,299,652,338,634,1624,21.7364532,18.41133005,40.14778325,20.81280788,39.03940887,1125700
933,94611,1014,586,1600,499,523,2622,38.67276888,22.34935164,61.02212052,19.03127384,19.94660564,1199600
934,94612,85,105,190,192,466,848,10.02358491,12.38207547,22.40566038,22.64150943,54.95283019,848500
935,94618,342,244,586,183,133,902,37.91574279,27.05099778,64.96674058,20.28824834,14.74501109,1440300
936,94619,160,225,385,325,650,1360,11.76470588,16.54411765,28.30882353,23.89705882,47.79411765,790500
937,94621,90,278,368,632,1755,2755,3.266787659,10.0907441,13.35753176,22.94010889,63.70235935,445600
938,94702,146,71,217,51,37,305,47.86885246,23.27868852,71.14754098,16.72131148,12.13114754,958700
939,94703,424,374,798,371,369,1538,27.56827048,24.31729519,51.88556567,24.12223667,23.99219766,1061200
940,94704,197,160,357,138,251,746,26.4075067,21.44772118,47.85522788,18.49865952,33.6461126,787300
941,94705,421,246,667,213,132,1012,41.60079051,24.3083004,65.90909091,21.04743083,13.04347826,1420900
942,94706,716,471,1187,331,227,1745,41.03151862,26.99140401,68.02292264,18.96848138,13.00859599,964500
943,94707,36,39,75,38,57,170,21.17647059,22.94117647,44.11764706,22.35294118,33.52941176,1301800
944,94708,168,97,265,65,43,373,45.04021448,26.00536193,71.04557641,17.42627346,11.52815013,1208400
945,94709,87,49,136,33,30,199,43.71859296,24.62311558,68.34170854,16.58291457,15.07537688,1001900
946,94710,81,50,131,36,19,186,43.5483871,26.88172043,70.43010753,19.35483871,10.21505376,898500
947,94801,40,108,148,280,967,1395,2.867383513,7.741935484,10.609319,20.07168459,69.31899642,475100
948,94803,101,173,274,309,833,1416,7.132768362,12.21751412,19.35028249,21.8220339,58.82768362,614700
949,94804,164,328,492,690,2050,3232,5.074257426,10.14851485,15.22277228,21.3490099,63.42821782,526600
950,94805,47,67,114,124,499,737,6.377204885,9.090909091,15.46811398,16.82496608,67.70691995,613400
951,94806,176,454,630,1090,2687,4407,3.993646472,10.3017926,14.29543907,24.73337872,60.97118221,479200
952,94901,392,424,816,608,1128,2552,15.36050157,16.61442006,31.97492163,23.82445141,44.20062696,1136000
953,94903,464,433,897,434,546,1877,24.72029835,23.06872669,47.78902504,23.1220032,29.08897176,940800
954,94904,307,183,490,168,93,751,40.87882823,24.36750999,65.24633822,22.3701731,12.38348868,1635600
955,94920,364,170,534,138,48,720,50.55555556,23.61111111,74.16666667,19.16666667,6.666666667,2000000
956,94923,2,0,2,3,6,11,18.18181818,0,18.18181818,27.27272727,54.54545455,1077700
957,94924,16,15,31,10,13,54,29.62962963,27.77777778,57.40740741,18.51851852,24.07407407,1119300
958,94925,252,103,355,68,37,460,54.7826087,22.39130435,77.17391304,14.7826087,8.043478261,1372500
959,94928,232,465,697,735,1335,2767,8.384531984,16.80520419,25.18973618,26.56306469,48.24719913,546100
960,94930,285,190,475,226,130,831,34.29602888,22.86401925,57.16004813,27.19614922,15.64380265,927100
961,94931,9,49,58,99,138,295,3.050847458,16.61016949,19.66101695,33.55932203,46.77966102,663100
962,94939,326,226,552,165,157,874,37.29977117,25.85812357,63.15789474,18.87871854,17.96338673,1697200
963,94941,780,533,1313,358,166,1837,42.46053348,29.01469788,71.47523136,19.48829614,9.03647251,1582800
964,94945,177,183,360,180,197,737,24.01628223,24.83039349,48.84667571,24.42333786,26.72998643,909300
965,94946,1,7,8,5,8,21,4.761904762,33.33333333,38.0952381,23.80952381,38.0952381,1736600
966,94947,309,381,690,475,588,1753,17.62692527,21.73416999,39.36109527,27.09640616,33.54249857,851100
967,94949,207,226,433,305,492,1230,16.82926829,18.37398374,35.20325203,24.79674797,40,829100
968,94951,38,78,116,82,43,241,15.76763485,32.36514523,48.13278008,34.02489627,17.84232365,955000
969,94952,601,605,1206,741,835,2782,21.60316319,21.74694464,43.35010784,26.63551402,30.01437815,866200
970,94954,480,618,1098,796,820,2714,17.68607222,22.77081798,40.4568902,29.3294031,30.21370671,661700
971,94956,13,21,34,28,44,106,12.26415094,19.81132075,32.0754717,26.41509434,41.50943396,1299500
972,94957,118,78,196,39,9,244,48.36065574,31.96721311,80.32786885,15.98360656,3.68852459,2000000
973,94960,266,206,472,122,85,679,39.17525773,30.33873343,69.51399116,17.96759941,12.51840943,1308500
974,94963,24,29,53,25,21,99,24.24242424,29.29292929,53.53535354,25.25252525,21.21212121,928600
975,94965,30,37,67,67,115,249,12.04819277,14.85943775,26.90763052,26.90763052,46.18473896,1173700
976,94971,9,23,32,41,67,140,6.428571429,16.42857143,22.85714286,29.28571429,47.85714286,845200
977,95002,42,45,87,45,47,179,23.46368715,25.1396648,48.60335196,25.1396648,26.25698324,659100
978,95003,304,361,665,397,533,1595,19.05956113,22.63322884,41.69278997,24.89028213,33.4169279,935600
979,95004,23,51,74,76,84,234,9.829059829,21.79487179,31.62393162,32.47863248,35.8974359,780500
980,95005,47,50,97,47,56,200,23.5,25,48.5,23.5,28,804800
981,95006,490,367,857,454,501,1812,27.0419426,20.25386313,47.29580574,25.05518764,27.64900662,646300
982,95008,389,313,702,337,439,1478,26.31935047,21.17726658,47.49661705,22.80108254,29.70230041,1230900
983,95010,89,120,209,192,237,638,13.94984326,18.80877743,32.75862069,30.09404389,37.14733542,760500
984,95012,27,108,135,345,1075,1555,1.736334405,6.945337621,8.681672026,22.18649518,69.1318328,486000
985,95014,4169,965,5134,522,412,6068,68.70468029,15.90309822,84.60777851,8.602504944,6.789716546,2000000
986,95017,11,19,30,25,14,69,15.94202899,27.53623188,43.47826087,36.23188406,20.28985507,908100
987,95018,124,187,311,210,233,754,16.44562334,24.80106101,41.24668435,27.85145889,30.90185676,657200
988,95019,16,48,64,75,140,279,5.734767025,17.20430108,22.9390681,26.88172043,50.17921147,471700
989,95020,786,973,1759,1462,2405,5626,13.97084963,17.29470316,31.26555279,25.98649129,42.74795592,815900
990,95023,525,903,1428,1488,2506,5422,9.682773884,16.65437108,26.33714496,27.44374769,46.21910734,609800
991,95030,649,354,1003,305,292,1600,40.5625,22.125,62.6875,19.0625,18.25,2000000
992,95032,933,455,1388,300,173,1861,50.13433638,24.44922085,74.58355723,16.12036539,9.296077378,1726700
993,95033,125,101,226,98,60,384,32.55208333,26.30208333,58.85416667,25.52083333,15.625,1160400
994,95035,2012,964,2976,829,929,4734,42.50105619,20.36332911,62.8643853,17.51161808,19.62399662,995200
995,95037,601,730,1331,876,1186,3393,17.7129384,21.51488358,39.22782199,25.8178603,34.95431771,954600
996,95045,17,21,38,86,165,289,5.882352941,7.266435986,13.14878893,29.75778547,57.09342561,726500
997,95046,16,38,54,113,256,423,3.78250591,8.983451537,12.76595745,26.71394799,60.52009456,1092500
998,95050,254,284,538,379,560,1477,17.19702099,19.2281652,36.42518619,25.66012187,37.91469194,1140200
999,95051,1092,614,1706,618,897,3221,33.90251475,19.06240298,52.96491773,19.18658802,27.84849426,1253100
1000,95054,211,198,409,185,244,838,25.17899761,23.62768496,48.80668258,22.07637232,29.11694511,1195700
1001,95060,467,439,906,433,491,1830,25.51912568,23.98907104,49.50819672,23.66120219,26.83060109,971100
1002,95062,226,394,620,519,779,1918,11.7831074,20.54223149,32.32533889,27.05943691,40.61522419,840100
1003,95065,67,111,178,113,109,400,16.75,27.75,44.5,28.25,27.25,931400
1004,95066,300,240,540,260,228,1028,29.18287938,23.3463035,52.52918288,25.29182879,22.17898833,920600
1005,95070,1505,442,1947,239,185,2371,63.47532687,18.64192324,82.11725011,10.08013496,7.80261493,2000000
1006,95073,124,165,289,170,202,661,18.75945537,24.96217852,43.72163389,25.71860817,30.55975794,842800
1007,95075,0,3,3,7,18,28,0,10.71428571,10.71428571,25,64.28571429,809000
1008,95076,268,673,941,1821,4835,7597,3.527708306,8.858760037,12.38646834,23.96998815,63.6435435,626100
1009,95110,112,235,347,362,638,1347,8.314773571,17.44617669,25.76095026,26.87453601,47.36451373,739600
1010,95111,587,659,1246,1010,1966,4222,13.90336333,15.60871625,29.51207958,23.9223117,46.56560872,661700
1011,95112,152,255,407,493,1275,2175,6.988505747,11.72413793,18.71264368,22.66666667,58.62068966,823900
1012,95116,264,453,717,801,1826,3344,7.894736842,13.54665072,21.44138756,23.95334928,54.60526316,687900
1013,95117,189,149,338,201,267,806,23.44913151,18.48635236,41.93548387,24.93796526,33.12655087,1141000
1014,95118,942,641,1583,731,1038,3352,28.1026253,19.12291169,47.22553699,21.80787589,30.96658711,1111900
1015,95119,342,209,551,279,418,1248,27.40384615,16.74679487,44.15064103,22.35576923,33.49358974,950700
1016,95120,1782,765,2547,639,534,3720,47.90322581,20.56451613,68.46774194,17.17741935,14.35483871,1546400
1017,95121,605,514,1119,550,780,2449,24.7039608,20.98815843,45.69211923,22.45814618,31.84973459,838900
1018,95122,889,938,1827,1442,2976,6245,14.23538831,15.02001601,29.25540432,23.09047238,47.6541233,674500
1019,95123,911,833,1744,915,1221,3880,23.47938144,21.46907216,44.94845361,23.58247423,31.46907216,889800
1020,95124,1976,1067,3043,757,658,4458,44.32480933,23.93449978,68.25930911,16.98070884,14.75998205,1259000
1021,95125,757,699,1456,980,1365,3801,19.91581163,18.3898974,38.30570902,25.78268877,35.91160221,1300600
1022,95126,149,225,374,413,1014,1801,8.273181566,12.49305941,20.76624098,22.93170461,56.30205441,1011900
1023,95127,236,419,655,723,1823,3201,7.372696032,13.08965948,20.46235551,22.58669166,56.95095283,806400
1024,95128,151,237,388,436,866,1690,8.934911243,14.02366864,22.95857988,25.79881657,51.24260355,1054000
1025,95129,2543,479,3022,270,196,3488,72.90711009,13.73279817,86.63990826,7.740825688,5.619266055,1641700
1026,95130,747,335,1082,378,481,1941,38.48531685,17.25914477,55.74446162,19.47449768,24.7810407,1409500
1027,95131,162,206,368,248,392,1008,16.07142857,20.43650794,36.50793651,24.6031746,38.88888889,976300
1028,95132,1451,783,2234,758,984,3976,36.49396378,19.69315895,56.18712274,19.06438632,24.74849095,1072200
1029,95133,148,236,384,374,818,1576,9.390862944,14.97461929,24.36548223,23.73096447,51.9035533,869200
1030,95134,27,34,61,53,80,194,13.91752577,17.5257732,31.44329897,27.31958763,41.2371134,379800
1031,95135,990,370,1360,194,168,1722,57.4912892,21.48664344,78.97793264,11.2659698,9.756097561,1158400
1032,95136,142,185,327,271,517,1115,12.73542601,16.59192825,29.32735426,24.30493274,46.367713,897500
1033,95138,288,139,427,110,75,612,47.05882353,22.7124183,69.77124183,17.97385621,12.25490196,1129600
1034,95139,113,151,264,201,364,829,13.63088058,18.21471653,31.8455971,24.24607961,43.90832328,904600
1035,95148,1243,883,2126,929,1266,4321,28.76648924,20.43508447,49.20157371,21.49965286,29.29877343,998600
1036,95202,97,211,308,448,1020,1776,5.461711712,11.88063063,17.34234234,25.22522523,57.43243243,265400
1037,95203,46,105,151,250,610,1011,4.549950544,10.38575668,14.93570722,24.72799209,60.33630069,268100
1038,95204,129,337,466,669,1479,2614,4.93496557,12.89211936,17.82708493,25.59296098,56.57995409,286300
1039,95205,137,314,451,784,2162,3397,4.032970268,9.243450103,13.27642037,23.07918752,63.64439211,225400
1040,95206,281,710,991,1901,5712,8604,3.265922827,8.251975825,11.51789865,22.09437471,66.38772664,291800
1041,95207,383,714,1097,1374,3018,5489,6.977591547,13.00783385,19.9854254,25.03188195,54.98269266,318500
1042,95209,504,578,1082,1014,2133,4229,11.91771104,13.6675337,25.58524474,23.9772996,50.43745566,367400
1043,95210,151,361,512,639,1246,2397,6.299541093,15.06049228,21.36003338,26.6583229,51.98164372,259000
1044,95212,416,698,1114,1080,1795,3989,10.42867887,17.49811983,27.9267987,27.07445475,44.99874655,401500
1045,95215,117,299,416,675,1493,2584,4.527863777,11.57120743,16.09907121,26.12229102,57.77863777,303500
1046,95219,347,376,723,558,846,2127,16.31405736,17.67748002,33.99153738,26.23413258,39.77433004,436900
1047,95220,65,136,201,199,206,606,10.72607261,22.44224422,33.16831683,32.83828383,33.99339934,642500
1048,95222,7,35,42,101,149,292,2.397260274,11.98630137,14.38356164,34.5890411,51.02739726,399200
1049,95223,10,22,32,18,21,71,14.08450704,30.98591549,45.07042254,25.35211268,29.57746479,360600
1050,95224,34,37,71,49,48,168,20.23809524,22.02380952,42.26190476,29.16666667,28.57142857,327800
1051,95228,10,14,24,47,64,135,7.407407407,10.37037037,17.77777778,34.81481481,47.40740741,350500
1052,95230,5,3,8,19,29,56,8.928571429,5.357142857,14.28571429,33.92857143,51.78571429,591900
1053,95231,7,30,37,102,237,376,1.861702128,7.978723404,9.840425532,27.12765957,63.03191489,341300
1054,95236,28,61,89,99,145,333,8.408408408,18.31831832,26.72672673,29.72972973,43.54354354,501400
1055,95237,31,54,85,88,161,334,9.281437126,16.16766467,25.4491018,26.34730539,48.20359281,372700
1056,95240,210,420,630,800,1557,2987,7.03046535,14.0609307,21.09139605,26.78272514,52.12587881,352400
1057,95242,562,763,1325,1167,1847,4339,12.95229316,17.58469693,30.53699009,26.89559806,42.56741185,440100
1058,95245,11,16,27,21,40,88,12.5,18.18181818,30.68181818,23.86363636,45.45454545,383800
1059,95247,22,30,52,29,27,108,20.37037037,27.77777778,48.14814815,26.85185185,25,357500
1060,95249,26,50,76,134,337,547,4.753199269,9.140767824,13.89396709,24.49725777,61.60877514,332300
1061,95252,35,116,151,268,473,892,3.923766816,13.0044843,16.92825112,30.04484305,53.02690583,360200
1062,95255,4,9,13,15,27,55,7.272727273,16.36363636,23.63636364,27.27272727,49.09090909,231500
1063,95301,417,713,1130,1089,1887,4106,10.15586946,17.36483195,27.52070141,26.52216269,45.9571359,288800
1064,95303,30,37,67,68,95,230,13.04347826,16.08695652,29.13043478,29.56521739,41.30434783,592600
1065,95304,340,353,693,546,907,2146,15.84342964,16.44920783,32.29263747,25.44268406,42.26467847,692400
1066,95306,5,21,26,23,22,71,7.042253521,29.57746479,36.61971831,32.3943662,30.98591549,283300
1067,95307,290,791,1081,1714,3606,6401,4.530542103,12.35744415,16.88798625,26.77706608,56.33494766,313000
1068,95310,29,33,62,90,112,264,10.98484848,12.5,23.48484848,34.09090909,42.42424242,379500
1069,95311,1,3,4,9,22,35,2.857142857,8.571428571,11.42857143,25.71428571,62.85714286,252400
1070,95313,19,44,63,65,134,262,7.251908397,16.79389313,24.04580153,24.80916031,51.14503817,494000
1071,95315,72,168,240,338,711,1289,5.585725369,13.03335919,18.61908456,26.22187742,55.15903801,273000
1072,95316,37,81,118,191,428,737,5.020352782,10.99050204,16.01085482,25.91587517,58.07327001,375000
1073,95317,13,15,28,37,30,95,13.68421053,15.78947368,29.47368421,38.94736842,31.57894737,425000
1074,95318,7,6,13,13,10,36,19.44444444,16.66666667,36.11111111,36.11111111,27.77777778,241500
1075,95319,2,12,14,62,176,252,0.793650794,4.761904762,5.555555556,24.6031746,69.84126984,194700
1076,95320,136,259,395,390,503,1288,10.55900621,20.10869565,30.66770186,30.27950311,39.05279503,448000
1077,95321,7,12,19,31,88,138,5.072463768,8.695652174,13.76811594,22.46376812,63.76811594,330900
1078,95322,36,90,126,216,617,959,3.753910323,9.384775808,13.13868613,22.52346194,64.33785193,354500
1079,95323,106,134,240,181,161,582,18.21305842,23.02405498,41.2371134,31.09965636,27.66323024,451400
1080,95324,70,196,266,298,556,1120,6.25,17.5,23.75,26.60714286,49.64285714,313200
1081,95326,80,188,268,330,607,1205,6.639004149,15.60165975,22.2406639,27.38589212,50.37344398,366500
1082,95327,13,26,39,54,105,198,6.565656566,13.13131313,19.6969697,27.27272727,53.03030303,271800
1083,95328,60,91,151,135,142,428,14.01869159,21.26168224,35.28037383,31.54205607,33.17757009,306000
1084,95329,3,20,23,37,79,139,2.158273381,14.38848921,16.54676259,26.61870504,56.83453237,284400
1085,95330,389,584,973,968,1456,3397,11.45128054,17.19163968,28.64292022,28.49573153,42.86134825,431400
1086,95333,15,33,48,104,194,346,4.335260116,9.537572254,13.87283237,30.05780347,56.06936416,274600
1087,95334,125,269,394,495,983,1872,6.677350427,14.36965812,21.04700855,26.44230769,52.51068376,246500
1088,95336,334,753,1087,1691,3004,5782,5.776547907,13.02317537,18.79972328,29.24593566,51.95434106,398100
1089,95337,264,449,713,700,903,2316,11.39896373,19.38687392,30.78583765,30.22452504,38.98963731,466500
1090,95338,72,100,172,180,281,633,11.37440758,15.79778831,27.17219589,28.43601896,44.39178515,320800
1091,95340,414,683,1097,1356,3162,5615,7.373107747,12.16384684,19.53695459,24.14959929,56.31344613,300400
1092,95341,189,465,654,864,1431,2949,6.408952187,15.76805697,22.17700916,29.29806714,48.5249237,232400
1093,95348,151,263,414,645,1439,2498,6.044835869,10.52842274,16.57325861,25.82065653,57.60608487,273400
1094,95350,541,1008,1549,1715,3408,6672,8.108513189,15.10791367,23.21642686,25.70443645,51.07913669,309800
1095,95351,170,538,708,1100,3133,4941,3.440599069,10.88848411,14.32908318,22.26269986,63.40821696,241800
1096,95354,137,205,342,370,919,1631,8.399754752,12.56897609,20.96873084,22.68546904,56.34580012,280500
1097,95355,838,1032,1870,1448,2407,5725,14.63755459,18.02620087,32.66375546,25.29257642,42.04366812,359200
1098,95356,240,362,602,461,628,1691,14.19278533,21.40745121,35.60023655,27.26197516,37.13778829,389900
1099,95357,69,208,277,380,882,1539,4.483430799,13.51526966,17.99870045,24.69135802,57.30994152,340300
1100,95358,249,421,670,813,1716,3199,7.783682401,13.16036261,20.94404501,25.41419193,53.64176305,319900
1101,95360,68,205,273,442,915,1630,4.171779141,12.57668712,16.74846626,27.11656442,56.13496933,298300
1102,95361,339,564,903,812,1058,2773,12.22502705,20.33898305,32.5640101,29.28236567,38.15362423,407700
1103,95363,155,386,541,821,1654,3016,5.139257294,12.79840849,17.93766578,27.22148541,54.84084881,360300
1104,95365,15,84,99,158,277,534,2.808988764,15.73033708,18.53932584,29.58801498,51.87265918,183900
1105,95366,424,539,963,627,674,2264,18.72791519,23.80742049,42.53533569,27.69434629,29.77031802,522100
1106,95367,122,287,409,462,841,1712,7.126168224,16.76401869,23.89018692,26.98598131,49.12383178,344800
1107,95368,115,230,345,354,610,1309,8.785332315,17.57066463,26.35599694,27.04354469,46.60045837,349000
1108,95369,6,5,11,10,17,38,15.78947368,13.15789474,28.94736842,26.31578947,44.73684211,339200
1109,95370,142,236,378,388,570,1336,10.62874251,17.66467066,28.29341317,29.04191617,42.66467066,342700
1110,95372,23,74,97,100,114,311,7.395498392,23.79421222,31.18971061,32.15434084,36.65594855,317000
1111,95374,0,5,5,15,38,58,0,8.620689655,8.620689655,25.86206897,65.51724138,357300
1112,95376,536,1022,1558,1627,3449,6634,8.079589991,15.40548689,23.48507688,24.52517335,51.98974977,454200
1113,95377,345,476,821,628,748,2197,15.70323168,21.66590806,37.36913974,28.58443332,34.04642695,594900
1114,95379,36,99,135,113,161,409,8.80195599,24.20537897,33.00733496,27.62836186,39.36430318,319000
1115,95380,208,460,668,842,1790,3300,6.303030303,13.93939394,20.24242424,25.51515152,54.24242424,319900
1116,95382,454,673,1127,987,1713,3827,11.86307813,17.58557617,29.4486543,25.79043637,44.76090933,374600
1117,95383,31,44,75,60,39,174,17.81609195,25.28735632,43.10344828,34.48275862,22.4137931,364200
1118,95386,118,260,378,417,728,1523,7.747866054,17.07156927,24.81943533,27.38017072,47.80039396,323200
1119,95387,4,19,23,42,86,151,2.649006623,12.58278146,15.23178808,27.81456954,56.95364238,445100
1120,95388,148,241,389,410,557,1356,10.91445428,17.77286136,28.68731563,30.2359882,41.07669617,231700
1121,95389,4,7,11,3,1,15,26.66666667,46.66666667,73.33333333,20,6.666666667,699100
1122,95391,1639,885,2524,644,483,3651,44.89181046,24.23993426,69.13174473,17.63900301,13.22925226,634300
1123,95401,207,359,566,614,1035,2215,9.34537246,16.20767494,25.5530474,27.72009029,46.7268623,541300
1124,95403,165,324,489,559,1207,2255,7.317073171,14.36807095,21.68514412,24.78935698,53.52549889,588800
1125,95404,152,288,440,472,723,1635,9.296636086,17.6146789,26.91131498,28.86850153,44.22018349,710100
1126,95405,325,460,785,649,843,2277,14.27316645,20.2020202,34.47518665,28.50241546,37.02239789,648800
1127,95407,202,505,707,1009,1918,3634,5.558613099,13.89653275,19.45514584,27.76554761,52.77930655,506600
1128,95409,588,543,1131,510,559,2200,26.72727273,24.68181818,51.40909091,23.18181818,25.40909091,665600
1129,95415,13,26,39,56,146,241,5.394190871,10.78838174,16.18257261,23.23651452,60.58091286,542200
1130,95421,2,2,4,5,2,11,18.18181818,18.18181818,36.36363636,45.45454545,18.18181818,571400
1131,95422,12,62,74,204,695,973,1.233299075,6.372045221,7.605344296,20.96608428,71.42857143,156400
1132,95423,1,6,7,25,80,112,0.892857143,5.357142857,6.25,22.32142857,71.42857143,223600
1133,95425,39,84,123,197,345,665,5.864661654,12.63157895,18.4962406,29.62406015,51.87969925,556700
1134,95426,5,20,25,28,18,71,7.042253521,28.16901408,35.21126761,39.43661972,25.35211268,260400
1135,95428,4,12,16,44,123,183,2.18579235,6.557377049,8.743169399,24.04371585,67.21311475,301300
1136,95436,6,26,32,65,71,168,3.571428571,15.47619048,19.04761905,38.69047619,42.26190476,578800
1137,95437,62,119,181,247,476,904,6.85840708,13.16371681,20.02212389,27.32300885,52.65486726,446400
1138,95441,3,17,20,24,52,96,3.125,17.70833333,20.83333333,25,54.16666667,952800
1139,95442,2,6,8,15,44,67,2.985074627,8.955223881,11.94029851,22.3880597,65.67164179,1177600
1140,95446,14,25,39,50,65,154,9.090909091,16.23376623,25.32467532,32.46753247,42.20779221,506700
1141,95448,106,154,260,210,309,779,13.6071887,19.76893453,33.37612323,26.957638,39.66623877,919400
1142,95449,2,4,6,12,27,45,4.444444444,8.888888889,13.33333333,26.66666667,60,465000
1143,95451,21,79,100,215,576,891,2.356902357,8.8664422,11.22334456,24.1301908,64.64646465,285000
1144,95452,18,20,38,12,15,65,27.69230769,30.76923077,58.46153846,18.46153846,23.07692308,915600
1145,95453,19,59,78,162,370,610,3.114754098,9.672131148,12.78688525,26.55737705,60.6557377,342500
1146,95454,8,25,33,42,83,158,5.063291139,15.82278481,20.88607595,26.58227848,52.53164557,371700
1147,95457,9,48,57,144,521,722,1.246537396,6.648199446,7.894736842,19.94459834,72.16066482,332800
1148,95458,8,17,25,42,96,163,4.90797546,10.42944785,15.33742331,25.76687117,58.89570552,234500
1149,95459,3,1,4,3,9,16,18.75,6.25,25,18.75,56.25,539800
1150,95460,29,47,76,62,53,191,15.18324607,24.60732984,39.79057592,32.46073298,27.7486911,566400
1151,95461,47,57,104,148,265,517,9.090909091,11.02514507,20.11605416,28.62669246,51.25725338,315900
1152,95462,2,8,10,12,17,39,5.128205128,20.51282051,25.64102564,30.76923077,43.58974359,562500
1153,95465,28,29,57,32,22,111,25.22522523,26.12612613,51.35135135,28.82882883,19.81981982,957300
1154,95466,12,14,26,24,28,78,15.38461538,17.94871795,33.33333333,30.76923077,35.8974359,583300
1155,95467,23,57,80,70,71,221,10.40723982,25.7918552,36.19909502,31.67420814,32.12669683,338300
1156,95468,12,29,41,55,106,202,5.940594059,14.35643564,20.2970297,27.22772277,52.47524752,494100
1157,95469,11,19,30,60,58,148,7.432432432,12.83783784,20.27027027,40.54054054,39.18918919,485000
1158,95470,40,59,99,136,259,494,8.097165992,11.94331984,20.04048583,27.53036437,52.4291498,495100
1159,95472,338,482,820,563,517,1900,17.78947368,25.36842105,43.15789474,29.63157895,27.21052632,890700
1160,95476,135,266,401,495,957,1853,7.285483001,14.35509984,21.64058284,26.71343767,51.64597949,767900
1161,95482,161,397,558,728,1505,2791,5.768541741,14.22429237,19.99283411,26.08384092,53.92332497,402700
1162,95485,32,62,94,110,226,430,7.441860465,14.41860465,21.86046512,25.58139535,52.55813953,299100
1163,95490,27,118,145,216,435,796,3.391959799,14.8241206,18.2160804,27.13567839,54.64824121,337600
1164,95492,207,382,589,640,1034,2263,9.147149801,16.88024746,26.02739726,28.28104286,45.69155988,652800
1165,95501,92,186,278,288,683,1249,7.365892714,14.89191353,22.25780624,23.05844676,54.683747,299400
1166,95503,185,368,553,554,726,1833,10.09274414,20.07637752,30.16912166,30.22367703,39.60720131,337600
1167,95519,78,162,240,252,318,810,9.62962963,20,29.62962963,31.11111111,39.25925926,352700
1168,95521,221,309,530,437,515,1482,14.9122807,20.85020243,35.76248313,29.48717949,34.75033738,379000
1169,95524,96,94,190,62,37,289,33.21799308,32.52595156,65.74394464,21.4532872,12.80276817,484900
1170,95525,12,15,27,38,52,117,10.25641026,12.82051282,23.07692308,32.47863248,44.44444444,388200
1171,95526,2,13,15,16,23,54,3.703703704,24.07407407,27.77777778,29.62962963,42.59259259,262100
1172,95527,14,7,21,10,13,44,31.81818182,15.90909091,47.72727273,22.72727273,29.54545455,272700
1173,95528,3,20,23,44,22,89,3.370786517,22.47191011,25.84269663,49.43820225,24.71910112,383900
1174,95531,86,200,286,444,1011,1741,4.939689833,11.48765078,16.42734061,25.50258472,58.07007467,236100
1175,95536,34,62,96,84,68,248,13.70967742,25,38.70967742,33.87096774,27.41935484,443500
1176,95540,77,146,223,291,586,1100,7,13.27272727,20.27272727,26.45454545,53.27272727,313500
1177,95546,1,11,12,46,229,287,0.348432056,3.832752613,4.181184669,16.02787456,79.79094077,257500
1178,95547,29,31,60,50,12,122,23.7704918,25.40983607,49.18032787,40.98360656,9.836065574,470800
1179,95548,0,3,3,7,33,43,0,6.976744186,6.976744186,16.27906977,76.74418605,200500
1180,95549,0,3,3,11,7,21,0,14.28571429,14.28571429,52.38095238,33.33333333,536500
1181,95551,0,1,1,10,55,66,0,1.515151515,1.515151515,15.15151515,83.33333333,391100
1182,95555,1,1,2,3,8,13,7.692307692,7.692307692,15.38461538,23.07692308,61.53846154,325000
1183,95556,2,3,5,13,24,42,4.761904762,7.142857143,11.9047619,30.95238095,57.14285714,337600
1184,95558,5,4,9,0,8,17,29.41176471,23.52941176,52.94117647,0,47.05882353,708300
1185,95560,10,24,34,37,81,152,6.578947368,15.78947368,22.36842105,24.34210526,53.28947368,341200
1186,95562,5,27,32,64,83,179,2.793296089,15.08379888,17.87709497,35.75418994,46.36871508,239000
1187,95564,0,1,1,6,25,32,0,3.125,3.125,18.75,78.125,333300
1188,95565,18,32,50,35,36,121,14.87603306,26.44628099,41.32231405,28.92561983,29.75206612,284600
1189,95567,14,18,32,40,83,155,9.032258065,11.61290323,20.64516129,25.80645161,53.5483871,254000
1190,95570,15,25,40,39,33,112,13.39285714,22.32142857,35.71428571,34.82142857,29.46428571,446600
1191,95573,4,8,12,28,57,97,4.12371134,8.24742268,12.37113402,28.86597938,58.7628866,314200
1192,95585,5,1,6,14,12,32,15.625,3.125,18.75,43.75,37.5,356700
1193,95589,3,5,8,7,22,37,8.108108108,13.51351351,21.62162162,18.91891892,59.45945946,405300
1194,95603,255,367,622,509,764,1895,13.45646438,19.36675462,32.823219,26.86015831,40.31662269,474900
1195,95605,65,124,189,223,626,1038,6.262042389,11.9460501,18.20809249,21.48362235,60.30828516,313500
1196,95608,1163,1401,2564,1966,3316,7846,14.82283966,17.85623248,32.67907214,25.05735407,42.2635738,448700
1197,95610,71,139,210,258,538,1006,7.057654076,13.81709742,20.87475149,25.64612326,53.47912525,375700
1198,95612,49,84,133,111,195,439,11.16173121,19.13439636,30.29612756,25.28473804,44.4191344,853100
1199,95614,26,37,63,41,26,130,20,28.46153846,48.46153846,31.53846154,20,430400
1200,95615,5,10,15,25,28,68,7.352941176,14.70588235,22.05882353,36.76470588,41.17647059,602300
1201,95616,1461,835,2296,713,638,3647,40.06032355,22.89553057,62.95585413,19.55031533,17.49383055,730800
1202,95618,95,74,169,79,105,353,26.9121813,20.9631728,47.87535411,22.3796034,29.74504249,697900
1203,95619,0,0,0,5,42,47,0,0,0,10.63829787,89.36170213,277300
1204,95620,152,291,443,449,785,1677,9.063804413,17.35241503,26.41621944,26.77400119,46.80977937,458600
1205,95621,104,253,357,484,960,1801,5.774569684,14.04775125,19.82232093,26.87395891,53.30372016,327900
1206,95623,45,71,116,125,158,399,11.27819549,17.79448622,29.0726817,31.3283208,39.59899749,443500
1207,95624,1921,1970,3891,2021,2308,8220,23.36982968,23.96593674,47.33576642,24.5863747,28.07785888,473300
1208,95626,10,13,23,40,95,158,6.329113924,8.227848101,14.55696203,25.3164557,60.12658228,396500
1209,95627,11,45,56,121,313,490,2.244897959,9.183673469,11.42857143,24.69387755,63.87755102,357900
1210,95628,314,494,808,708,872,2388,13.14907873,20.68676717,33.8358459,29.64824121,36.5159129,489000
1211,95630,2492,1581,4073,1290,933,6296,39.58068615,25.1111817,64.69186785,20.48919949,14.81893266,598100
1212,95631,47,83,130,89,83,302,15.56291391,27.48344371,43.04635762,29.47019868,27.48344371,409400
1213,95632,311,568,879,783,1016,2678,11.61314414,21.2098581,32.82300224,29.23823749,37.93876027,403000
1214,95633,25,45,70,56,108,234,10.68376068,19.23076923,29.91452991,23.93162393,46.15384615,341700
1215,95634,28,47,75,69,130,274,10.2189781,17.15328467,27.37226277,25.18248175,47.44525547,323700
1216,95636,1,2,3,3,5,11,9.090909091,18.18181818,27.27272727,27.27272727,45.45454545,281900
1217,95638,45,70,115,89,92,296,15.2027027,23.64864865,38.85135135,30.06756757,31.08108108,585700
1218,95640,9,38,47,78,89,214,4.205607477,17.75700935,21.96261682,36.44859813,41.58878505,345100
1219,95641,18,17,35,29,29,93,19.35483871,18.27956989,37.6344086,31.1827957,31.1827957,259800
1220,95642,70,178,248,310,541,1099,6.369426752,16.19654231,22.56596906,28.20746133,49.22656961,348900
1221,95645,18,28,46,33,40,119,15.12605042,23.52941176,38.65546218,27.73109244,33.61344538,343700
1222,95648,933,1182,2115,1486,1584,5185,17.99421408,22.79652845,40.79074253,28.65959499,30.54966249,514000
1223,95650,645,593,1238,496,240,1974,32.67477204,30.04052685,62.71529889,25.1266464,12.15805471,682700
1224,95655,97,75,172,76,85,333,29.12912913,22.52252252,51.65165165,22.82282282,25.52552553,433100
1225,95658,134,161,295,154,114,563,23.80106572,28.59680284,52.39786856,27.35346359,20.24866785,702600
1226,95659,180,278,458,429,573,1460,12.32876712,19.04109589,31.36986301,29.38356164,39.24657534,435700
1227,95660,174,331,505,654,1602,2761,6.302064469,11.98841,18.29047447,23.6870699,58.02245563,256000
1228,95661,715,712,1427,800,760,2987,23.9370606,23.83662538,47.77368597,26.78272514,25.44358889,550300
1229,95662,520,676,1196,919,997,3112,16.70951157,21.72236504,38.43187661,29.53084833,32.03727506,408300
1230,95663,56,59,115,36,10,161,34.7826087,36.64596273,71.42857143,22.36024845,6.211180124,713900
1231,95666,10,19,29,26,38,93,10.75268817,20.43010753,31.1827957,27.95698925,40.86021505,288400
1232,95667,440,670,1110,1054,1312,3476,12.65822785,19.27502877,31.93325662,30.32220944,37.74453395,434200
1233,95668,18,35,53,30,35,118,15.25423729,29.66101695,44.91525424,25.42372881,29.66101695,480000
1234,95669,12,23,35,30,43,108,11.11111111,21.2962963,32.40740741,27.77777778,39.81481481,459000
1235,95670,408,591,999,1033,2036,4068,10.02949853,14.5280236,24.55752212,25.39331367,50.04916421,375500
1236,95672,221,235,456,232,177,865,25.54913295,27.16763006,52.71676301,26.82080925,20.46242775,573400
1237,95673,229,385,614,562,1084,2260,10.13274336,17.03539823,27.16814159,24.86725664,47.96460177,340100
1238,95674,4,13,17,29,32,78,5.128205128,16.66666667,21.79487179,37.17948718,41.02564103,456300
1239,95677,638,529,1167,490,390,2047,31.16756229,25.84269663,57.01025892,23.93746947,19.05227162,506800
1240,95678,543,742,1285,933,1136,3354,16.18962433,22.1228384,38.31246273,27.81753131,33.87000596,426500
1241,95681,1,5,6,10,15,31,3.225806452,16.12903226,19.35483871,32.25806452,48.38709677,312700
1242,95682,414,452,866,467,355,1688,24.52606635,26.77725118,51.30331754,27.66587678,21.03080569,544400
1243,95683,79,55,134,48,31,213,37.08920188,25.82159624,62.91079812,22.53521127,14.55399061,550800
1244,95684,18,22,40,56,69,165,10.90909091,13.33333333,24.24242424,33.93939394,41.81818182,460700
1245,95685,47,81,128,110,182,420,11.19047619,19.28571429,30.47619048,26.19047619,43.33333333,447400
1246,95686,8,23,31,31,58,120,6.666666667,19.16666667,25.83333333,25.83333333,48.33333333,311000
1247,95687,345,669,1014,1085,1675,3774,9.141494436,17.72655008,26.86804452,28.74933757,44.38261791,459300
1248,95688,476,705,1181,967,1302,3450,13.79710145,20.43478261,34.23188406,28.02898551,37.73913043,563300
1249,95690,2,17,19,33,40,92,2.173913043,18.47826087,20.65217391,35.86956522,43.47826087,601900
1250,95691,414,589,1003,861,1391,3255,12.71889401,18.0952381,30.8141321,26.4516129,42.73425499,412100
1251,95692,102,179,281,235,314,830,12.28915663,21.56626506,33.85542169,28.31325301,37.8313253,310900
1252,95693,56,61,117,68,49,234,23.93162393,26.06837607,50,29.05982906,20.94017094,657600
1253,95694,58,99,157,225,407,789,7.351077313,12.54752852,19.89860583,28.51711027,51.5842839,474000
1254,95695,276,561,837,963,1899,3699,7.461476075,15.16626115,22.62773723,26.03406326,51.33819951,402800
1255,95697,0,0,0,3,52,55,0,0,0,5.454545455,94.54545455,170300
1256,95701,2,7,9,16,31,56,3.571428571,12.5,16.07142857,28.57142857,55.35714286,460400
1257,95709,35,53,88,93,89,270,12.96296296,19.62962963,32.59259259,34.44444444,32.96296296,465300
1258,95713,56,91,147,129,121,397,14.10579345,22.92191436,37.02770781,32.49370277,30.47858942,422400
1259,95722,15,17,32,14,26,72,20.83333333,23.61111111,44.44444444,19.44444444,36.11111111,547200
1260,95726,32,82,114,138,150,402,7.960199005,20.39800995,28.35820896,34.32835821,37.31343284,341300
1261,95742,397,302,699,239,181,1119,35.47810545,26.98838248,62.46648794,21.35835567,16.17515639,472200
1262,95746,623,400,1023,305,166,1494,41.70013387,26.77376171,68.47389558,20.41499331,11.11111111,852900
1263,95747,1858,1855,3713,1984,1670,7367,25.22057825,25.17985612,50.40043437,26.9309081,22.66865753,537300
1264,95757,1896,1642,3538,1564,1310,6412,29.56955708,25.60823456,55.17779164,24.39176544,20.43044292,507100
1265,95758,735,917,1652,1208,1616,4476,16.42091153,20.487042,36.90795353,26.98838248,36.10366399,434500
1266,95762,1825,1765,3590,1728,1533,6851,26.63844694,25.76266239,52.40110933,25.22259524,22.37629543,699100
1267,95765,1806,1431,3237,1273,832,5342,33.80756271,26.78771996,60.59528267,23.83002621,15.57469113,578900
1268,95776,104,167,271,229,421,921,11.29207383,18.13246471,29.42453855,24.86427796,45.7111835,429900
1269,95814,12,23,35,40,73,148,8.108108108,15.54054054,23.64864865,27.02702703,49.32432432,544600
1270,95815,48,167,215,363,1096,1674,2.867383513,9.976105137,12.84348865,21.68458781,65.47192354,247400
1271,95816,400,250,650,281,365,1296,30.86419753,19.29012346,50.15432099,21.68209877,28.16358025,631100
1272,95817,55,89,144,197,408,749,7.343124166,11.88251001,19.22563418,26.30173565,54.47263017,374200
1273,95818,402,369,771,451,833,2055,19.5620438,17.95620438,37.51824818,21.94647202,40.53527981,660600
1274,95819,356,283,639,227,361,1227,29.01385493,23.06438468,52.07823961,18.5004075,29.42135289,637200
1275,95820,158,299,457,543,1403,2403,6.57511444,12.44277986,19.0178943,22.59675406,58.38535164,317700
1276,95821,309,348,657,635,1665,2957,10.44978018,11.76868448,22.21846466,21.47446737,56.30706797,374500
1277,95822,284,421,705,728,1621,3054,9.299279633,13.78519974,23.08447937,23.83759005,53.07793058,355400
1278,95823,418,946,1364,1872,3964,7200,5.805555556,13.13888889,18.94444444,26,55.05555556,285600
1279,95824,123,187,310,441,1329,2080,5.913461538,8.990384615,14.90384615,21.20192308,63.89423077,243800
1280,95825,19,71,90,193,857,1140,1.666666667,6.228070175,7.894736842,16.92982456,75.1754386,331300
1281,95826,205,366,571,569,1108,2248,9.119217082,16.28113879,25.40035587,25.3113879,49.28825623,349300
1282,95827,34,134,168,234,659,1061,3.204524034,12.62959472,15.83411876,22.05466541,62.11121583,328800
1283,95828,340,592,932,1108,2202,4242,8.015087223,13.95568128,21.97076851,26.11975483,51.90947666,309800
1284,95829,512,588,1100,773,998,2871,17.83350749,20.48066876,38.31417625,26.92441658,34.76140718,429800
1285,95831,412,510,922,697,1032,2651,15.54130517,19.23802339,34.77932856,26.2919653,38.92870615,485300
1286,95832,81,128,209,310,506,1025,7.902439024,12.48780488,20.3902439,30.24390244,49.36585366,319400
1287,95833,219,439,658,910,1963,3531,6.202209006,12.4327386,18.63494761,25.77173605,55.59331634,349900
1288,95834,276,324,600,404,659,1663,16.59651233,19.4828623,36.07937462,24.29344558,39.6271798,415800
1289,95835,761,986,1747,1355,1951,5053,15.06036018,19.5131605,34.57352068,26.81575302,38.6107263,452000
1290,95838,150,399,549,953,2905,4407,3.40367597,9.05377808,12.45745405,21.624688,65.91785795,276000
1291,95841,52,84,136,104,187,427,12.17798595,19.67213115,31.8501171,24.3559719,43.79391101,308800
1292,95842,171,303,474,475,966,1915,8.929503916,15.82245431,24.75195822,24.80417755,50.44386423,289300
1293,95843,474,757,1231,1046,1347,3624,13.0794702,20.88852097,33.96799117,28.86313466,37.16887417,361900
1294,95864,388,532,920,751,1092,2763,14.0427072,19.25443359,33.29714079,27.1806008,39.52225841,643200
1295,95901,172,411,583,898,1430,2911,5.908622467,14.1188595,20.02748196,30.84850567,49.12401237,269300
1296,95912,56,126,182,202,326,710,7.887323944,17.74647887,25.63380282,28.45070423,45.91549296,351000
1297,95914,3,14,17,19,19,55,5.454545455,25.45454545,30.90909091,34.54545455,34.54545455,306900
1298,95917,13,23,36,51,167,254,5.118110236,9.05511811,14.17322835,20.07874016,65.7480315,275000
1299,95918,18,24,42,24,10,76,23.68421053,31.57894737,55.26315789,31.57894737,13.15789474,532700
1300,95922,4,4,8,13,4,25,16,16,32,52,16,266200
1301,95926,824,1023,1847,1229,1704,4780,17.23849372,21.40167364,38.64016736,25.71129707,35.64853556,370500
1302,95928,471,553,1024,733,868,2625,17.94285714,21.06666667,39.00952381,27.92380952,33.06666667,388800
1303,95932,57,136,193,234,296,723,7.883817427,18.81051176,26.69432918,32.36514523,40.94052559,285200
1304,95936,0,3,3,5,4,12,0,25,25,41.66666667,33.33333333,1024200
1305,95938,81,134,215,147,146,508,15.94488189,26.37795276,42.32283465,28.93700787,28.74015748,477700
1306,95939,2,5,7,2,12,21,9.523809524,23.80952381,33.33333333,9.523809524,57.14285714,138100
1307,95942,6,9,15,23,26,64,9.375,14.0625,23.4375,35.9375,40.625,392300
1308,95945,251,403,654,556,785,1995,12.58145363,20.20050125,32.78195489,27.86967419,39.34837093,391400
1309,95946,44,81,125,109,137,371,11.85983827,21.8328841,33.69272237,29.38005391,36.92722372,443600
1310,95947,3,8,11,16,14,41,7.317073171,19.51219512,26.82926829,39.02439024,34.14634146,240100
1311,95948,133,274,407,379,422,1208,11.00993377,22.68211921,33.69205298,31.37417219,34.93377483,260600
1312,95949,139,249,388,312,359,1059,13.12559018,23.51274788,36.63833805,29.46175637,33.89990557,448500
1313,95951,7,36,43,65,227,335,2.089552239,10.74626866,12.8358209,19.40298507,67.76119403,240300
1314,95953,160,239,399,377,597,1373,11.65331391,17.40713765,29.06045157,27.4581209,43.48142753,276300
1315,95954,14,22,36,67,129,232,6.034482759,9.482758621,15.51724138,28.87931034,55.60344828,194500
1316,95955,22,48,70,66,64,200,11,24,35,33,32,283100
1317,95957,151,230,381,306,474,1161,13.00602929,19.81050818,32.81653747,26.35658915,40.82687339,278300
1318,95959,237,263,500,353,475,1328,17.84638554,19.80421687,37.65060241,26.5813253,35.76807229,519400
1319,95961,239,450,689,863,1751,3303,7.2358462,13.6239782,20.8598244,26.12776264,53.01241296,292400
1320,95962,1,4,5,17,62,84,1.19047619,4.761904762,5.952380952,20.23809524,73.80952381,297500
1321,95963,141,250,391,429,974,1794,7.859531773,13.93534002,21.79487179,23.91304348,54.29208473,278200
1322,95965,63,230,293,392,620,1305,4.827586207,17.62452107,22.45210728,30.03831418,47.50957854,216400
1323,95966,96,256,352,544,1211,2107,4.556241101,12.14997627,16.70621737,25.81869957,57.47508306,244400
1324,95968,18,34,52,105,206,363,4.958677686,9.366391185,14.32506887,28.92561983,56.74931129,156800
1325,95969,46,112,158,142,246,546,8.424908425,20.51282051,28.93772894,26.00732601,45.05494505,300000
1326,95970,1,12,13,20,36,69,1.449275362,17.39130435,18.84057971,28.98550725,52.17391304,450000
1327,95971,59,99,158,151,158,467,12.63383298,21.19914347,33.83297645,32.33404711,33.83297645,266100
1328,95973,22,36,58,42,23,123,17.88617886,29.26829268,47.15447154,34.14634146,18.69918699,402600
1329,95979,5,2,7,4,9,20,25,10,35,20,45,250000
1330,95982,40,97,137,146,206,489,8.1799591,19.83640082,28.01635992,29.85685072,42.12678937,292700
1331,95987,12,46,58,147,487,692,1.734104046,6.647398844,8.38150289,21.24277457,70.37572254,310300
1332,95988,43,107,150,252,391,793,5.422446406,13.49306431,18.91551072,31.77805801,49.30643127,244100
1333,95991,275,585,860,1030,2179,4069,6.758417302,14.37699681,21.13541411,25.3133448,53.55124109,297900
1334,95993,386,523,909,758,1129,2796,13.80543634,18.70529328,32.51072961,27.11015737,40.37911302,353700
1335,96001,501,643,1144,720,846,2710,18.48708487,23.72693727,42.21402214,26.56826568,31.21771218,319700
1336,96002,274,434,708,704,993,2405,11.39293139,18.04573805,29.43866944,29.27234927,41.28898129,280900
1337,96003,353,597,950,777,908,2635,13.39658444,22.65654649,36.05313093,29.48766603,34.45920304,299600
1338,96007,130,237,367,350,683,1400,9.285714286,16.92857143,26.21428571,25,48.78571429,235900
1339,96008,39,58,97,58,52,207,18.84057971,28.01932367,46.85990338,28.01932367,25.12077295,197700
1340,96009,2,13,15,23,33,71,2.816901408,18.30985915,21.12676056,32.3943662,46.47887324,277800
1341,96013,17,36,53,92,119,264,6.439393939,13.63636364,20.07575758,34.84848485,45.07575758,169500
1342,96017,3,9,12,7,12,31,9.677419355,29.03225806,38.70967742,22.58064516,38.70967742,258300
1343,96019,89,122,211,218,313,742,11.99460916,16.44204852,28.43665768,29.38005391,42.18328841,219700
1344,96020,12,24,36,60,63,159,7.547169811,15.09433962,22.64150943,37.73584906,39.62264151,229200
1345,96021,97,235,332,418,1007,1757,5.520774047,13.37507114,18.89584519,23.79055208,57.31360273,212900
1346,96022,250,350,600,450,472,1522,16.42575558,22.99605782,39.4218134,29.56636005,31.01182654,263300
1347,96023,0,2,2,1,9,12,0,16.66666667,16.66666667,8.333333333,75,120300
1348,96024,41,36,77,18,15,110,37.27272727,32.72727273,70,16.36363636,13.63636364,278800
1349,96025,1,5,6,13,44,63,1.587301587,7.936507937,9.523809524,20.63492063,69.84126984,232200
1350,96027,11,30,41,34,26,101,10.89108911,29.7029703,40.59405941,33.66336634,25.74257426,240800
1351,96028,16,31,47,63,37,147,10.88435374,21.08843537,31.97278912,42.85714286,25.17006803,286100
1352,96029,2,4,6,14,15,35,5.714285714,11.42857143,17.14285714,40,42.85714286,311500
1353,96032,32,43,75,89,63,227,14.0969163,18.94273128,33.03964758,39.20704846,27.75330396,253400
1354,96033,2,6,8,6,1,15,13.33333333,40,53.33333333,40,6.666666667,130000
1355,96034,1,4,5,4,15,24,4.166666667,16.66666667,20.83333333,16.66666667,62.5,305300
1356,96035,0,10,10,57,188,255,0,3.921568627,3.921568627,22.35294118,73.7254902,223500
1357,96038,14,32,46,44,35,125,11.2,25.6,36.8,35.2,28,213900
1358,96039,2,7,9,17,47,73,2.739726027,9.589041096,12.32876712,23.28767123,64.38356164,143800
1359,96041,33,49,82,34,26,142,23.23943662,34.50704225,57.74647887,23.94366197,18.30985915,310100
1360,96044,3,3,6,7,9,22,13.63636364,13.63636364,27.27272727,31.81818182,40.90909091,177100
1361,96047,2,6,8,6,11,25,8,24,32,24,44,367600
1362,96048,14,14,28,13,8,49,28.57142857,28.57142857,57.14285714,26.53061224,16.32653061,330600
1363,96052,2,6,8,9,23,40,5,15,20,22.5,57.5,282500
1364,96055,62,80,142,95,166,403,15.38461538,19.85111663,35.23573201,23.57320099,41.191067,229300
1365,96056,11,23,34,22,43,99,11.11111111,23.23232323,34.34343434,22.22222222,43.43434343,266500
1366,96057,5,5,10,16,14,40,12.5,12.5,25,40,35,237500
1367,96062,52,53,105,48,26,179,29.05027933,29.60893855,58.65921788,26.81564246,14.52513966,325000
1368,96064,26,37,63,90,123,276,9.420289855,13.4057971,22.82608696,32.60869565,44.56521739,199100
1369,96065,4,13,17,15,23,55,7.272727273,23.63636364,30.90909091,27.27272727,41.81818182,267700
1370,96067,62,105,167,173,281,621,9.98389694,16.90821256,26.8921095,27.85829308,45.24959742,320300
1371,96069,1,4,5,10,13,28,3.571428571,14.28571429,17.85714286,35.71428571,46.42857143,327000
1372,96073,171,205,376,223,175,774,22.09302326,26.48578811,48.57881137,28.81136951,22.60981912,451900
1373,96080,161,327,488,677,1227,2392,6.730769231,13.67056856,20.40133779,28.30267559,51.29598662,250400
1374,96087,4,12,16,19,28,63,6.349206349,19.04761905,25.3968254,30.15873016,44.44444444,334500
1375,96088,2,16,18,33,78,129,1.550387597,12.40310078,13.95348837,25.58139535,60.46511628,257200
1376,96092,6,21,27,21,14,62,9.677419355,33.87096774,43.5483871,33.87096774,22.58064516,275000
1377,96093,44,64,108,80,89,277,15.88447653,23.10469314,38.98916968,28.88086643,32.1299639,298300
1378,96094,30,67,97,103,167,367,8.174386921,18.25613079,26.43051771,28.0653951,45.50408719,248600
1379,96097,28,111,139,208,397,744,3.76344086,14.91935484,18.6827957,27.95698925,53.36021505,190300
1380,96101,27,73,100,128,193,421,6.413301663,17.33966746,23.75296912,30.40380048,45.8432304,145900
1381,96104,7,10,17,18,21,56,12.5,17.85714286,30.35714286,32.14285714,37.5,174400
1382,96107,13,19,32,36,23,91,14.28571429,20.87912088,35.16483516,39.56043956,25.27472527,245800
1383,96109,8,15,23,41,83,147,5.442176871,10.20408163,15.6462585,27.89115646,56.46258503,186400
1384,96114,16,44,60,71,92,223,7.174887892,19.7309417,26.9058296,31.83856502,41.25560538,295100
1385,96118,21,36,57,69,51,177,11.86440678,20.33898305,32.20338983,38.98305085,28.81355932,215000
1386,96120,3,4,7,6,17,30,10,13.33333333,23.33333333,20,56.66666667,375300
1387,96122,25,58,83,89,114,286,8.741258741,20.27972028,29.02097902,31.11888112,39.86013986,198000
1388,96130,108,187,295,347,488,1130,9.557522124,16.54867257,26.10619469,30.7079646,43.18584071,218100
1389,96134,8,24,32,55,122,209,3.827751196,11.48325359,15.31100478,26.31578947,58.37320574,130100
1390,96137,1,16,17,26,41,84,1.19047619,19.04761905,20.23809524,30.95238095,48.80952381,236300
1391,96143,51,33,84,29,55,168,30.35714286,19.64285714,50,17.26190476,32.73809524,542100
1392,96145,128,133,261,141,166,568,22.53521127,23.41549296,45.95070423,24.82394366,29.22535211,785700
1393,96146,82,39,121,18,2,141,58.15602837,27.65957447,85.81560284,12.76595745,1.418439716,1203900
1394,96150,187,309,496,468,816,1780,10.50561798,17.35955056,27.86516854,26.29213483,45.84269663,488200
1395,96161,391,335,726,331,321,1378,28.37445573,24.31059507,52.6850508,24.0203193,23.2946299,653600
},,,,,,,,,,,,,