Index,Zip Code,Students Standard Exceeded_english2022,Students Standard Met_english2022,Students Standard Met and Above_english2022,Students Standard Nearly Met_english2022,Students Standard Not Met_english2022,Students with Scores_english2022,Percentage Standard Exceeded_english2022,Percentage Standard Met_english2022,Percentage Standard Met and Above_english2022,Percentage Standard Nearly Met_english2022,Percentage Standard Not Met_english2022,Median Mortgage
0,90001,517,1295,1812,1485,2707,6004,8.610926049,21.56895403,30.17988008,24.73351099,45.08660893,425200
1,90002,209,476,685,659,1517,2861,7.305138064,16.63753932,23.94267739,23.03390423,53.02341839,411500
2,90003,610,1386,1996,1679,3227,6902,8.838017966,20.0811359,28.91915387,24.32628224,46.75456389,430800
3,90004,787,785,1572,705,1005,3282,23.97928093,23.91834247,47.8976234,21.48080439,30.62157221,1148400
4,90005,714,1235,1949,1067,1413,4429,16.12102055,27.88439828,44.00541883,24.09121698,31.90336419,964700
5,90006,168,371,539,486,878,1903,8.828166054,19.49553337,28.32369942,25.53862323,46.13767735,716900
6,90007,530,1313,1843,1329,1805,4977,10.64898533,26.38135423,37.03033956,26.70283303,36.26682741,717300
7,90008,66,189,255,275,633,1163,5.674978504,16.25107481,21.92605331,23.64574377,54.42820292,781600
8,90010,50,122,172,143,206,521,9.596928983,23.41650672,33.0134357,27.44721689,39.53934741,822100
9,90011,760,1956,2716,2432,4610,9758,7.788481246,20.04509121,27.83357245,24.92313999,47.24328756,452100
10,90012,276,274,550,167,222,939,29.39297125,29.1799787,58.57294995,17.78487753,23.64217252,633000
11,90013,37,97,134,98,112,344,10.75581395,28.19767442,38.95348837,28.48837209,32.55813953,664800
12,90015,179,354,533,390,580,1503,11.9095143,23.55289421,35.46240852,25.94810379,38.58948769,715000
13,90016,235,531,766,556,915,2237,10.50514081,23.73714797,34.24228878,24.85471614,40.90299508,677500
14,90017,151,358,509,485,1277,2271,6.64905328,15.76398063,22.41303391,21.35623074,56.23073536,697100
15,90018,318,684,1002,718,1116,2836,11.21297602,24.11847673,35.33145275,25.31734838,39.35119887,704300
16,90019,429,576,1005,498,825,2328,18.42783505,24.74226804,43.17010309,21.39175258,35.43814433,1033900
17,90020,38,117,155,134,175,464,8.189655172,25.21551724,33.40517241,28.87931034,37.71551724,650300
18,90021,57,130,187,180,309,676,8.431952663,19.23076923,27.66272189,26.62721893,45.71005917,1013900
19,90022,733,1518,2251,1462,1923,5636,13.00567779,26.93399574,39.93967353,25.94038325,34.11994322,471000
20,90023,643,1381,2024,1368,1893,5285,12.16650899,26.13055818,38.29706717,25.884579,35.81835383,479600
21,90024,341,241,582,123,148,853,39.97655334,28.25322392,68.22977726,14.41969519,17.35052755,1231000
22,90025,447,428,875,267,222,1364,32.771261,31.37829912,64.14956012,19.57478006,16.27565982,905900
23,90026,489,812,1301,886,1241,3428,14.26487748,23.68728121,37.95215869,25.84597433,36.20186698,962100
24,90027,291,205,496,158,160,814,35.74938575,25.18427518,60.93366093,19.41031941,19.65601966,1287200
25,90028,261,480,741,423,603,1767,14.77079796,27.16468591,41.93548387,23.93887946,34.12563667,723000
26,90029,468,726,1194,548,593,2335,20.04282655,31.09207709,51.13490364,23.46895075,25.39614561,898400
27,90031,337,597,934,549,681,2164,15.57301294,27.58780037,43.16081331,25.36968577,31.46950092,616900
28,90032,460,642,1102,635,795,2532,18.16745656,25.35545024,43.52290679,25.07898894,31.39810427,605400
29,90033,521,705,1226,662,1110,2998,17.37825217,23.51567712,40.89392929,22.08138759,37.02468312,538900
30,90034,714,797,1511,536,509,2556,27.9342723,31.18153365,59.11580595,20.97026604,19.91392801,1152500
31,90035,338,427,765,289,290,1344,25.14880952,31.77083333,56.91964286,21.50297619,21.57738095,1494600
32,90036,87,66,153,65,58,276,31.52173913,23.91304348,55.43478261,23.55072464,21.01449275,1634700
33,90037,336,603,939,742,1367,3048,11.02362205,19.78346457,30.80708661,24.34383202,44.84908136,502000
34,90038,108,290,398,322,456,1176,9.183673469,24.65986395,33.84353741,27.38095238,38.7755102,945000
35,90039,228,163,391,122,135,648,35.18518519,25.15432099,60.33950617,18.82716049,20.83333333,972900
36,90040,55,133,188,151,276,615,8.943089431,21.62601626,30.56910569,24.55284553,44.87804878,452100
37,90041,669,621,1290,372,370,2032,32.92322835,30.56102362,63.48425197,18.30708661,18.20866142,886800
38,90042,377,684,1061,742,853,2656,14.19427711,25.75301205,39.94728916,27.93674699,32.11596386,731600
39,90043,243,674,917,823,1397,3137,7.746254383,21.4854957,29.23175008,26.23525661,44.53299331,684500
40,90044,330,738,1068,1011,2429,4508,7.320319432,16.37089618,23.69121562,22.42679681,53.88198758,461200
41,90045,547,537,1084,394,425,1903,28.74408828,28.21860221,56.96269049,20.70415134,22.33315817,1103500
42,90046,699,467,1166,326,307,1799,38.8549194,25.95886604,64.81378544,18.12117843,17.06503613,1290400
43,90047,219,566,785,692,1417,2894,7.567380788,19.5577056,27.12508639,23.91154112,48.96337249,519400
44,90048,92,60,152,43,61,256,35.9375,23.4375,59.375,16.796875,23.828125,1441200
45,90049,877,793,1670,346,289,2305,38.04772234,34.40347072,72.45119306,15.01084599,12.53796095,2000000
46,90057,195,378,573,411,717,1701,11.4638448,22.22222222,33.68606702,24.1622575,42.15167549,576200
47,90058,21,39,60,53,94,207,10.14492754,18.84057971,28.98550725,25.60386473,45.41062802,419600
48,90059,241,602,843,659,1177,2679,8.99589399,22.4710713,31.46696529,24.59873087,43.93430384,415100
49,90061,168,538,706,615,1313,2634,6.378132118,20.42520881,26.80334093,23.34851936,49.84813971,438800
50,90062,118,341,459,390,801,1650,7.151515152,20.66666667,27.81818182,23.63636364,48.54545455,550600
51,90063,1012,2154,3166,2433,3968,9567,10.57802864,22.51489495,33.09292359,25.43116965,41.47590676,481100
52,90064,283,289,572,215,260,1047,27.0296084,27.60267431,54.63228271,20.53486151,24.83285578,1388300
53,90065,716,1043,1759,843,961,3563,20.0954252,29.27308448,49.36850968,23.65983722,26.9716531,833400
54,90066,897,1071,1968,802,869,3639,24.64962902,29.43116241,54.08079143,22.03902171,23.88018686,1282100
55,90068,19,23,42,16,9,67,28.35820896,34.32835821,62.68656716,23.88059701,13.43283582,1500800
56,90069,72,34,106,20,10,136,52.94117647,25,77.94117647,14.70588235,7.352941176,890100
57,90077,123,37,160,13,6,179,68.7150838,20.67039106,89.38547486,7.262569832,3.351955307,2000000
58,90094,108,42,150,32,14,196,55.10204082,21.42857143,76.53061224,16.32653061,7.142857143,1132000
59,90201,873,1930,2803,2170,3381,8354,10.45008379,23.10270529,33.55278908,25.97558056,40.47163036,440500
60,90210,131,79,210,33,21,264,49.62121212,29.92424242,79.54545455,12.5,7.954545455,2000000
61,90211,149,77,226,41,38,305,48.85245902,25.24590164,74.09836066,13.44262295,12.45901639,2000000
62,90212,370,359,729,172,159,1060,34.90566038,33.86792453,68.77358491,16.22641509,15,2000000
63,90220,453,876,1329,806,1430,3565,12.70687237,24.57223001,37.27910238,22.60869565,40.11220196,394900
64,90221,474,1000,1474,1032,1759,4265,11.1137163,23.44665885,34.56037515,24.19695193,41.24267292,412600
65,90222,404,649,1053,516,642,2211,18.27227499,29.35323383,47.62550882,23.33785617,29.03663501,420700
66,90230,1132,1049,2181,655,580,3416,33.1381733,30.70843091,63.84660422,19.17447307,16.97892272,849200
67,90232,169,128,297,113,124,534,31.64794007,23.97003745,55.61797753,21.16104869,23.22097378,1219100
68,90240,467,660,1127,547,629,2303,20.27789839,28.65827182,48.93617021,23.75162831,27.31220148,646900
69,90241,930,1341,2271,1093,1181,4545,20.4620462,29.5049505,49.9669967,24.04840484,25.98459846,627700
70,90242,656,1275,1931,1173,1347,4451,14.73826106,28.64524826,43.38350932,26.3536284,30.26286228,557700
71,90245,825,622,1447,279,185,1911,43.1711146,32.54840398,75.71951858,14.59968603,9.680795395,1244200
72,90247,311,594,905,715,1184,2804,11.09129815,21.18402282,32.27532097,25.49928673,42.2253923,540800
73,90248,89,173,262,172,260,694,12.82420749,24.92795389,37.75216138,24.78386167,37.46397695,571200
74,90249,121,132,253,112,138,503,24.055666,26.24254473,50.29821074,22.26640159,27.43538767,584000
75,90250,1349,2070,3419,1691,2013,7123,18.93864945,29.06078899,47.99943844,23.73999719,28.26056437,661400
76,90254,374,284,658,102,58,818,45.72127139,34.71882641,80.4400978,12.46943765,7.090464548,1674500
77,90255,1079,2297,3376,2374,3307,9057,11.91343712,25.36159876,37.27503588,26.2117699,36.51319421,455000
78,90260,703,1324,2027,1047,1103,4177,16.83026095,31.69739047,48.52765142,25.06583672,26.40651185,597300
79,90262,652,1347,1999,1524,2760,6283,10.37720834,21.43880312,31.81601146,24.2559287,43.92805984,449600
80,90265,215,224,439,80,49,568,37.85211268,39.43661972,77.28873239,14.08450704,8.626760563,2000000
81,90266,1386,933,2319,346,162,2827,49.02723735,33.00318359,82.03042094,12.23912274,5.730456314,2000000
82,90270,322,511,833,459,552,1844,17.46203905,27.71149675,45.17353579,24.89154013,29.93492408,481800
83,90272,477,324,801,161,118,1080,44.16666667,30,74.16666667,14.90740741,10.92592593,2000000
84,90274,1101,735,1836,300,149,2285,48.18380744,32.16630197,80.35010941,13.12910284,6.520787746,1757700
85,90275,1764,1513,3277,635,425,4337,40.67327646,34.88586581,75.55914226,14.64145723,9.799400507,1247000
86,90277,983,857,1840,421,241,2502,39.28856914,34.25259792,73.54116707,16.82653877,9.632294165,1143800
87,90278,969,795,1764,416,240,2420,40.04132231,32.85123967,72.89256198,17.19008264,9.917355372,992600
88,90280,1112,2176,3288,2298,3240,8826,12.59913891,24.65443009,37.253569,26.03670972,36.70972128,470200
89,90290,23,33,56,16,10,82,28.04878049,40.24390244,68.29268293,19.51219512,12.19512195,1184900
90,90291,288,161,449,135,127,711,40.50632911,22.64416315,63.15049226,18.98734177,17.86216596,1899800
91,90292,20,57,77,53,80,210,9.523809524,27.14285714,36.66666667,25.23809524,38.0952381,1076900
92,90293,21,32,53,24,32,109,19.26605505,29.35779817,48.62385321,22.01834862,29.35779817,899000
93,90301,226,642,868,680,987,2535,8.915187377,25.32544379,34.24063116,26.82445759,38.93491124,547900
94,90302,325,454,779,404,464,1647,19.7328476,27.56527019,47.29811779,24.52944748,28.17243473,590000
95,90303,128,312,440,363,686,1489,8.596373405,20.95366017,29.55003358,24.3787777,46.07118872,606100
96,90304,381,808,1189,852,927,2968,12.83692722,27.22371968,40.0606469,28.70619946,31.23315364,586600
97,90305,47,74,121,78,79,278,16.90647482,26.61870504,43.52517986,28.05755396,28.41726619,646500
98,90402,114,51,165,10,5,180,63.33333333,28.33333333,91.66666667,5.555555556,2.777777778,2000000
99,90403,740,451,1191,187,86,1464,50.54644809,30.80601093,81.35245902,12.77322404,5.87431694,1523400
100,90404,157,109,266,53,52,371,42.3180593,29.38005391,71.69811321,14.28571429,14.01617251,922900
101,90405,795,707,1502,333,282,2117,37.55314124,33.39631554,70.94945678,15.72980633,13.32073689,1430800
102,90501,514,603,1117,437,385,1939,26.50850954,31.09850438,57.60701392,22.53739041,19.85559567,724900
103,90502,69,97,166,112,155,433,15.93533487,22.40184758,38.33718245,25.86605081,35.79676674,520700
104,90503,1292,1239,2531,650,421,3602,35.86896169,34.39755691,70.2665186,18.04553026,11.68795114,861000
105,90504,855,819,1674,517,397,2588,33.03709428,31.64605873,64.68315301,19.97681607,15.34003091,712300
106,90505,1320,1019,2339,489,326,3154,41.85161699,32.30818009,74.15979708,15.50412175,10.33608117,916100
107,90601,372,622,994,594,704,2292,16.23036649,27.13787086,43.36823735,25.91623037,30.71553229,626500
108,90602,57,83,140,93,124,357,15.96638655,23.24929972,39.21568627,26.05042017,34.73389356,601600
109,90603,295,217,512,127,116,755,39.07284768,28.74172185,67.81456954,16.82119205,15.36423841,649600
110,90604,1083,1560,2643,1152,913,4708,23.00339847,33.13508921,56.13848768,24.46898895,19.39252336,591400
111,90605,763,1161,1924,926,1056,3906,19.53405018,29.7235023,49.25755248,23.70711726,27.03533026,556000
112,90606,440,710,1150,635,687,2472,17.79935275,28.72168285,46.5210356,25.68770227,27.79126214,509600
113,90620,471,662,1133,527,709,2369,19.88180667,27.94428029,47.82608696,22.24567328,29.92823976,622700
114,90621,396,517,913,474,683,2070,19.13043478,24.97584541,44.10628019,22.89855072,32.99516908,643200
115,90623,764,697,1461,391,365,2217,34.46098331,31.43888137,65.89986468,17.63644565,16.46368967,739200
116,90630,1936,1297,3233,643,439,4315,44.86674392,30.05793743,74.92468134,14.90150637,10.17381228,700100
117,90631,820,1219,2039,1070,1281,4390,18.67881549,27.76765376,46.44646925,24.37357631,29.17995444,628900
118,90638,741,934,1675,709,670,3054,24.2632613,30.58284217,54.84610347,23.21545514,21.93844139,630100
119,90640,546,1258,1804,1374,1989,5167,10.56706019,24.34681633,34.91387652,26.59183278,38.49429069,558600
120,90650,966,1727,2693,1602,2187,6482,14.90280778,26.64301142,41.54581919,24.71459426,33.73958655,487800
121,90660,604,1000,1604,1031,1352,3987,15.14923501,25.08151492,40.23074994,25.85904189,33.91020818,490300
122,90670,421,591,1012,393,345,1750,24.05714286,33.77142857,57.82857143,22.45714286,19.71428571,492100
123,90680,67,95,162,90,120,372,18.01075269,25.53763441,43.5483871,24.19354839,32.25806452,472800
124,90701,265,394,659,362,333,1354,19.57163959,29.09896603,48.67060561,26.73559823,24.59379616,635000
125,90703,3070,1874,4944,958,703,6605,46.47993944,28.37244512,74.85238456,14.50416351,10.64345193,762700
126,90704,33,46,79,68,102,249,13.25301205,18.47389558,31.72690763,27.30923695,40.96385542,863800
127,90706,295,690,985,726,992,2703,10.91379948,25.52719201,36.44099149,26.8590455,36.699963,535300
128,90710,181,272,453,234,343,1030,17.57281553,26.40776699,43.98058252,22.7184466,33.30097087,523400
129,90712,407,627,1034,526,640,2200,18.5,28.5,47,23.90909091,29.09090909,622800
130,90713,539,856,1395,722,638,2755,19.56442831,31.0707804,50.63520871,26.20689655,23.15789474,638600
131,90715,173,349,522,299,379,1200,14.41666667,29.08333333,43.5,24.91666667,31.58333333,555400
132,90716,69,176,245,216,247,708,9.745762712,24.85875706,34.60451977,30.50847458,34.88700565,442000
133,90717,301,446,747,434,478,1659,18.14345992,26.88366486,45.02712477,26.16033755,28.81253767,649400
134,90720,2143,1346,3489,594,262,4345,49.32105869,30.97813579,80.29919448,13.67088608,6.029919448,1004200
135,90723,617,1485,2102,1618,1947,5667,10.88759485,26.20434092,37.09193577,28.55126169,34.35680254,411900
136,90731,558,926,1484,876,1256,3616,15.43141593,25.60840708,41.03982301,24.22566372,34.73451327,657700
137,90732,215,164,379,128,148,655,32.82442748,25.03816794,57.86259542,19.54198473,22.59541985,657400
138,90740,135,88,223,66,38,327,41.28440367,26.91131498,68.19571865,20.18348624,11.62079511,442000
139,90744,528,1019,1547,1075,1835,4457,11.84653354,22.86291227,34.70944582,24.1193628,41.17119138,471000
140,90745,792,1194,1986,1136,1226,4348,18.21527139,27.46090156,45.67617295,26.12695492,28.19687213,516000
141,90746,153,351,504,372,536,1412,10.83569405,24.85835694,35.69405099,26.34560907,37.96033994,585600
142,90755,162,283,445,311,379,1135,14.27312775,24.9339207,39.20704846,27.40088106,33.39207048,553100
143,90802,208,414,622,401,634,1657,12.55280628,24.98491249,37.53771877,24.2003621,38.26191913,460300
144,90803,587,414,1001,208,235,1444,40.65096953,28.67036011,69.32132964,14.40443213,16.27423823,943000
145,90804,486,775,1261,667,727,2655,18.30508475,29.19020716,47.4952919,25.12241055,27.38229755,541000
146,90805,572,1337,1909,1438,2189,5536,10.33236994,24.15101156,34.4833815,25.97543353,39.54118497,469100
147,90806,287,420,707,424,618,1749,16.40937679,24.01372213,40.42309891,24.24242424,35.33447684,568400
148,90807,605,682,1287,520,639,2446,24.73426002,27.88225675,52.61651676,21.25919869,26.12428455,661100
149,90808,1457,1521,2978,896,677,4551,32.01494177,33.4212261,65.43616788,19.68798066,14.87585146,708300
150,90810,407,684,1091,756,1164,3011,13.51710395,22.71670541,36.23380937,25.10793756,38.65825307,464500
151,90813,428,812,1240,946,1455,3641,11.75501236,22.3015655,34.05657786,25.98187311,39.96154902,430500
152,90814,134,130,264,98,130,492,27.23577236,26.42276423,53.65853659,19.91869919,26.42276423,738900
153,90815,1183,1167,2350,732,650,3732,31.69882101,31.27009646,62.96891747,19.61414791,17.41693462,701600
154,91001,370,400,770,380,537,1687,21.93242442,23.7107291,45.64315353,22.52519265,31.83165382,887100
155,91006,995,956,1951,418,398,2767,35.95952295,34.55005421,70.50957716,15.10661366,14.38380918,1074000
156,91007,1040,593,1633,300,263,2196,47.35883424,27.00364299,74.36247723,13.66120219,11.97632058,1056600
157,91008,147,200,347,136,130,613,23.98042414,32.62642741,56.60685155,22.18597064,21.20717781,1414100
158,91010,301,339,640,288,384,1312,22.94207317,25.83841463,48.7804878,21.95121951,29.26829268,560900
159,91011,1251,586,1837,190,62,2089,59.88511249,28.05169938,87.93681187,9.09526089,2.967927238,1671000
160,91016,674,690,1364,520,653,2537,26.56681119,27.19747734,53.76428853,20.49664959,25.73906188,707400
161,91024,326,290,616,145,112,873,37.34249714,33.2187858,70.56128293,16.6093929,12.82932417,1048300
162,91030,1277,675,1952,278,188,2418,52.81224152,27.91563275,80.72787428,11.49710505,7.775020678,1174400
163,91040,168,282,450,287,322,1059,15.86402266,26.62889518,42.49291785,27.10103872,30.40604344,638100
164,91042,105,169,274,176,231,681,15.4185022,24.8164464,40.2349486,25.84434655,33.92070485,617400
165,91101,48,125,173,141,270,584,8.219178082,21.40410959,29.62328767,24.14383562,46.23287671,615200
166,91103,124,208,332,259,431,1022,12.13307241,20.35225049,32.4853229,25.34246575,42.17221135,780200
167,91104,292,400,692,394,569,1655,17.64350453,24.16918429,41.81268882,23.80664653,34.38066465,836500
168,91105,51,55,106,39,45,190,26.84210526,28.94736842,55.78947368,20.52631579,23.68421053,1306200
169,91106,105,163,268,127,224,619,16.9628433,26.33279483,43.29563813,20.51696284,36.18739903,811200
170,91107,494,378,872,302,447,1621,30.47501542,23.31893893,53.79395435,18.63047502,27.57557064,913700
171,91108,809,373,1182,114,63,1359,59.52906549,27.44665195,86.97571744,8.388520971,4.635761589,2000000
172,91201,351,347,698,236,231,1165,30.12875536,29.78540773,59.91416309,20.25751073,19.82832618,916000
173,91202,459,514,973,402,392,1767,25.9762309,29.08885116,55.06508206,22.75042445,22.18449349,876700
174,91203,46,40,86,41,73,200,23,20,43,20.5,36.5,592600
175,91204,164,121,285,76,81,442,37.1040724,27.37556561,64.47963801,17.19457014,18.32579186,561800
176,91205,434,379,813,362,440,1615,26.87306502,23.46749226,50.34055728,22.41486068,27.24458204,677200
177,91206,438,784,1222,652,712,2586,16.93735499,30.31709203,47.25444702,25.21268368,27.5328693,910500
178,91208,265,216,481,116,96,693,38.23953824,31.16883117,69.40836941,16.73881674,13.85281385,1054700
179,91214,1892,1326,3218,600,369,4187,45.18748507,31.66945307,76.85693814,14.33006926,8.812992596,851700
180,91301,665,594,1259,341,203,1803,36.88297282,32.94509151,69.82806434,18.91292291,11.25901276,871000
181,91302,888,963,1851,523,402,2776,31.98847262,34.69020173,66.67867435,18.84005764,14.48126801,1341400
182,91303,159,280,439,355,624,1418,11.21297602,19.7461213,30.95909732,25.03526093,44.00564175,536400
183,91304,284,337,621,351,568,1540,18.44155844,21.88311688,40.32467532,22.79220779,36.88311688,677700
184,91306,300,584,884,605,997,2486,12.06757844,23.4915527,35.55913113,24.33628319,40.10458568,592400
185,91307,399,214,613,103,112,828,48.1884058,25.84541063,74.03381643,12.43961353,13.52657005,714600
186,91311,562,669,1231,505,550,2286,24.58442695,29.26509186,53.84951881,22.09098863,24.05949256,679000
187,91316,220,119,339,83,73,495,44.44444444,24.04040404,68.48484848,16.76767677,14.74747475,724500
188,91320,912,895,1807,489,422,2718,33.55408389,32.92862399,66.48270787,17.99116998,15.52612215,755800
189,91321,877,1131,2008,774,766,3548,24.71815107,31.87711387,56.59526494,21.8151071,21.58962796,513500
190,91324,801,912,1713,563,534,2810,28.50533808,32.45551601,60.96085409,20.03558719,19.00355872,680200
191,91325,786,819,1605,615,764,2984,26.34048257,27.4463807,53.78686327,20.60991957,25.60321716,720900
192,91326,809,410,1219,201,153,1573,51.43038779,26.06484425,77.49523204,12.77813096,9.726636999,846700
193,91331,613,1129,1742,1287,2160,5189,11.81345153,21.75756408,33.57101561,24.80246676,41.62651763,487600
194,91335,878,1173,2051,913,1156,4120,21.31067961,28.47087379,49.7815534,22.16019417,28.05825243,580500
195,91340,424,1111,1535,1200,1761,4496,9.430604982,24.71085409,34.14145907,26.69039146,39.16814947,515000
196,91342,806,1455,2261,1334,1722,5317,15.15892421,27.36505548,42.52397969,25.08933609,32.38668422,520900
197,91343,629,1062,1691,1152,1999,4842,12.99049979,21.9330855,34.9235853,23.79182156,41.28459314,608500
198,91344,1902,2332,4234,1451,1343,7028,27.06317587,33.18155948,60.24473534,20.64598748,19.10927718,690300
199,91345,91,67,158,72,98,328,27.74390244,20.42682927,48.17073171,21.95121951,29.87804878,558000
200,91350,1162,1083,2245,702,576,3523,32.98325291,30.74084587,63.72409878,19.92619926,16.34970196,605800
201,91351,828,1311,2139,987,860,3986,20.77270447,32.8901154,53.66281987,24.76166583,21.5755143,471900
202,91352,571,1229,1800,1303,1898,5001,11.41771646,24.57508498,35.99280144,26.05478904,37.95240952,584100
203,91354,1249,1245,2494,571,298,3363,37.13945882,37.0205174,74.15997621,16.9788879,8.861135891,648600
204,91355,1038,738,1776,384,335,2495,41.60320641,29.57915832,71.18236473,15.39078156,13.42685371,600200
205,91356,695,631,1326,357,381,2064,33.67248062,30.57170543,64.24418605,17.29651163,18.45930233,1023000
206,91360,812,738,1550,474,397,2421,33.53985956,30.48327138,64.02313094,19.57868649,16.39818257,735100
207,91361,462,457,919,378,421,1718,26.89173458,26.60069849,53.49243306,22.00232829,24.50523865,1042900
208,91362,1035,865,1900,443,413,2756,37.55442671,31.38606676,68.94049347,16.07402032,14.98548621,878300
209,91364,545,500,1045,303,239,1587,34.34152489,31.50598614,65.84751103,19.0926276,15.05986137,949000
210,91367,1072,1420,2492,925,844,4261,25.15841352,33.32551044,58.48392396,21.70851913,19.80755691,786200
211,91377,1025,721,1746,277,125,2148,47.71880819,33.56610801,81.2849162,12.89571695,5.819366853,823300
212,91381,1273,773,2046,288,138,2472,51.49676375,31.27022654,82.76699029,11.65048544,5.582524272,851300
213,91384,454,655,1109,373,411,1893,23.98309562,34.60116218,58.58425779,19.70417327,21.71156894,579800
214,91387,482,598,1080,464,484,2028,23.76725838,29.48717949,53.25443787,22.87968442,23.86587771,599500
215,91390,26,41,67,54,55,176,14.77272727,23.29545455,38.06818182,30.68181818,31.25,647600
216,91401,293,363,656,318,556,1530,19.1503268,23.7254902,42.87581699,20.78431373,36.33986928,798900
217,91402,329,710,1039,845,1369,3253,10.11374116,21.82600676,31.93974792,25.97602213,42.08422994,483700
218,91403,100,116,216,90,104,410,24.3902439,28.29268293,52.68292683,21.95121951,25.36585366,1129100
219,91405,246,512,758,587,991,2336,10.53082192,21.91780822,32.44863014,25.12842466,42.42294521,581600
220,91406,575,986,1561,928,1097,3586,16.03457892,27.49581707,43.53039598,25.87841606,30.59118795,608600
221,91411,465,593,1058,509,823,2390,19.45606695,24.81171548,44.26778243,21.29707113,34.43514644,759300
222,91423,529,589,1118,323,273,1714,30.86347725,34.36406068,65.22753792,18.84480747,15.92765461,1066600
223,91436,266,194,460,62,35,557,47.75583483,34.82944345,82.58527828,11.13105925,6.283662478,1545300
224,91501,185,184,369,134,155,658,28.11550152,27.96352584,56.07902736,20.36474164,23.556231,827400
225,91502,183,169,352,86,59,497,36.82092555,34.00402414,70.8249497,17.30382294,11.87122736,761400
226,91504,489,649,1138,447,324,1909,25.6155055,33.99685699,59.61236249,23.41540073,16.97223677,819100
227,91505,516,577,1093,402,324,1819,28.36723474,31.72072567,60.08796042,22.10005498,17.81198461,812500
228,91506,478,680,1158,480,453,2091,22.85987566,32.5203252,55.38020086,22.95552367,21.66427547,850600
229,91601,619,420,1039,314,388,1741,35.55427915,24.12406663,59.67834578,18.03561172,22.2860425,744500
230,91602,513,445,958,302,323,1583,32.40682249,28.1111813,60.51800379,19.07770057,20.40429564,873700
231,91604,240,86,326,49,29,404,59.40594059,21.28712871,80.69306931,12.12871287,7.178217822,1263200
232,91605,228,552,780,625,1131,2536,8.990536278,21.76656151,30.75709779,24.64511041,44.5977918,605900
233,91606,300,513,813,570,852,2235,13.42281879,22.95302013,36.37583893,25.5033557,38.12080537,648100
234,91607,206,113,319,70,48,437,47.1395881,25.85812357,72.99771167,16.01830664,10.98398169,864100
235,91701,1401,1370,2771,744,497,4012,34.92023928,34.14755733,69.06779661,18.5443669,12.38783649,577200
236,91702,306,831,1137,829,1159,3125,9.792,26.592,36.384,26.528,37.088,474100
237,91706,860,1622,2482,1501,2086,6069,14.17037403,26.72598451,40.89635854,24.73224584,34.37139562,465900
238,91708,296,297,593,265,244,1102,26.86025408,26.95099819,53.81125227,24.04718693,22.1415608,488900
239,91709,2712,2085,4797,1037,891,6725,40.32713755,31.00371747,71.33085502,15.42007435,13.24907063,676800
240,91710,985,1573,2558,1508,1779,5845,16.85201027,26.9118905,43.76390077,25.79982891,30.43627032,512600
241,91711,948,1053,2001,718,605,3324,28.5198556,31.67870036,60.19855596,21.60048135,18.2009627,714400
242,91722,371,621,992,580,695,2267,16.36524041,27.39303044,43.75827084,25.58447287,30.65725629,513600
243,91723,507,850,1357,643,655,2655,19.0960452,32.01506591,51.11111111,24.21845574,24.67043315,579100
244,91724,319,508,827,445,435,1707,18.6877563,29.75981254,48.44756883,26.06912712,25.48330404,613400
245,91730,922,1341,2263,1066,1180,4509,20.4479929,29.74051896,50.18851187,23.64160568,26.16988246,452400
246,91731,423,605,1028,442,527,1997,21.18177266,30.29544316,51.47721582,22.1331998,26.38958438,497100
247,91732,773,1399,2172,1400,2141,5713,13.53054437,24.4880098,38.01855417,24.50551374,37.47593208,517800
248,91733,352,503,855,467,594,1916,18.37160752,26.2526096,44.62421712,24.3736952,31.00208768,486400
249,91737,914,724,1638,370,218,2226,41.06019766,32.524708,73.58490566,16.62174304,9.793351303,659500
250,91739,2208,1892,4100,972,665,5737,38.48701412,32.97890884,71.46592296,16.94265295,11.59142409,648400
251,91740,273,290,563,244,220,1027,26.58227848,28.2375852,54.81986368,23.75851996,21.42161636,590200
252,91741,803,979,1782,638,433,2853,28.14581143,34.3147564,62.46056782,22.36242552,15.17700666,757100
253,91744,744,1562,2306,1588,2002,5896,12.61872456,26.49253731,39.11126187,26.93351425,33.95522388,463200
254,91745,1449,1345,2794,842,857,4493,32.25016693,29.93545515,62.18562208,18.74026263,19.07411529,647300
255,91746,256,445,701,446,610,1757,14.57029027,25.32726238,39.89755265,25.38417758,34.71826978,488400
256,91748,689,674,1363,491,621,2475,27.83838384,27.23232323,55.07070707,19.83838384,25.09090909,663600
257,91750,473,313,786,141,123,1050,45.04761905,29.80952381,74.85714286,13.42857143,11.71428571,630400
258,91752,313,510,823,597,823,2243,13.95452519,22.73740526,36.69193045,26.6161391,36.69193045,521900
259,91754,1017,783,1800,418,444,2662,38.20435763,29.41397446,67.61833208,15.70247934,16.67918858,687700
260,91755,330,249,579,206,242,1027,32.13242454,24.24537488,56.37779942,20.05842259,23.56377799,639900
261,91759,8,17,25,15,11,51,15.68627451,33.33333333,49.01960784,29.41176471,21.56862745,380000
262,91761,760,1374,2134,1038,1182,4354,17.4552136,31.55718879,49.01240239,23.84014699,27.14745062,452900
263,91762,720,1508,2228,1301,1635,5164,13.94268009,29.20216886,43.14484895,25.19364833,31.66150271,437700
264,91763,662,1215,1877,1049,1194,4120,16.06796117,29.49029126,45.55825243,25.46116505,28.98058252,423700
265,91764,555,1029,1584,1090,1605,4279,12.97032017,24.04767469,37.01799486,25.47324141,37.50876373,415600
266,91765,1756,1301,3057,666,546,4269,41.13375498,30.4755212,71.60927618,15.60084329,12.78988053,709800
267,91766,594,1063,1657,1186,1826,4669,12.72221032,22.76718783,35.48939816,25.40158492,39.10901692,452700
268,91767,338,817,1155,947,1441,3543,9.539937906,23.05955405,32.59949196,26.72876094,40.67174711,449500
269,91768,253,515,768,540,839,2147,11.78388449,23.98695855,35.77084304,25.15137401,39.07778295,427500
270,91770,1280,1157,2437,742,939,4118,31.08305002,28.09616319,59.17921321,18.01845556,22.80233123,601300
271,91773,1260,1292,2552,798,513,3863,32.61713694,33.44550867,66.06264561,20.65752006,13.27983433,625400
272,91775,361,209,570,158,146,874,41.30434783,23.91304348,65.2173913,18.0778032,16.70480549,861400
273,91776,738,738,1476,451,587,2514,29.35560859,29.35560859,58.71121718,17.93953858,23.34924423,698900
274,91780,1001,800,1801,381,419,2601,38.485198,30.757401,69.242599,14.64821223,16.10918877,766200
275,91784,450,506,956,320,203,1479,30.42596349,34.21230561,64.6382691,21.6362407,13.7254902,666800
276,91786,578,832,1410,775,994,3179,18.18181818,26.17175212,44.35357031,24.37873545,31.26769424,483400
277,91789,2115,1549,3664,753,629,5046,41.91438763,30.69758224,72.61196988,14.92271106,12.46531906,790500
278,91790,749,936,1685,733,943,3361,22.28503422,27.84885451,50.13388872,21.80898542,28.05712586,594000
279,91791,594,698,1292,497,683,2472,24.02912621,28.23624595,52.26537217,20.10517799,27.62944984,647400
280,91792,137,351,488,331,408,1227,11.16544417,28.60635697,39.77180114,26.97636512,33.25183374,557100
281,91801,1121,916,2037,568,677,3282,34.15600244,27.90981109,62.06581353,17.30652041,20.62766606,662100
282,91803,338,427,765,347,345,1457,23.19835278,29.30679478,52.50514756,23.8160604,23.67879204,643900
283,91901,166,341,507,269,295,1071,15.49953315,31.83940243,47.33893557,25.11671335,27.54435107,644200
284,91902,184,203,387,166,210,763,24.11533421,26.60550459,50.72083879,21.75622543,27.52293578,732000
285,91905,5,16,21,29,41,91,5.494505495,17.58241758,23.07692308,31.86813187,45.05494505,280400
286,91906,24,58,82,70,149,301,7.973421927,19.26910299,27.24252492,23.25581395,49.50166113,282800
287,91910,1822,2912,4734,2118,2304,9156,19.89951944,31.80428135,51.70380079,23.13237221,25.163827,549100
288,91911,906,1621,2527,1470,2145,6142,14.75089547,26.39205471,41.14295018,23.93357213,34.92347769,485300
289,91913,1625,1530,3155,953,765,4873,33.34701416,31.39749641,64.74451057,19.55674123,15.6987482,578600
290,91914,853,973,1826,579,462,2867,29.75235438,33.9379142,63.69026857,20.19532612,16.1144053,739300
291,91915,1164,1112,2276,648,537,3461,33.6318983,32.12944236,65.76134065,18.72291245,15.51574689,604600
292,91916,27,33,60,32,29,121,22.31404959,27.27272727,49.58677686,26.44628099,23.96694215,479600
293,91932,192,401,593,413,684,1690,11.36094675,23.72781065,35.0887574,24.43786982,40.47337278,639200
294,91935,41,107,148,114,167,429,9.557109557,24.94172494,34.4988345,26.57342657,38.92773893,681300
295,91941,713,786,1499,605,623,2727,26.14594793,28.82288229,54.96883022,22.18555189,22.8456179,684900
296,91942,650,862,1512,491,453,2456,26.46579805,35.09771987,61.56351792,19.99185668,18.44462541,578600
297,91945,169,396,565,450,652,1667,10.13797241,23.75524895,33.89322136,26.99460108,39.11217756,478800
298,91950,521,1196,1717,1364,2046,5127,10.16188804,23.32748196,33.48937,26.604252,39.906378,450700
299,91962,33,89,122,107,104,333,9.90990991,26.72672673,36.63663664,32.13213213,31.23123123,433300
300,91963,11,25,36,40,123,199,5.527638191,12.56281407,18.09045226,20.10050251,61.80904523,350000
301,91977,569,1035,1604,918,1343,3865,14.72186287,26.77878396,41.50064683,23.75161708,34.74773609,493000
302,91978,169,199,368,139,132,639,26.44757433,31.14241002,57.58998435,21.75273865,20.657277,454100
303,92003,207,287,494,186,223,903,22.92358804,31.78294574,54.70653378,20.59800664,24.69545958,720300
304,92004,10,35,45,48,106,199,5.025125628,17.5879397,22.61306533,24.12060302,53.26633166,320600
305,92007,146,123,269,59,38,366,39.89071038,33.60655738,73.49726776,16.12021858,10.38251366,1304000
306,92008,1170,1126,2296,678,445,3419,34.22053232,32.93360632,67.15413864,19.83035975,13.01550161,881300
307,92009,1536,929,2465,480,300,3245,47.33436055,28.62865948,75.96302003,14.79198767,9.244992296,964200
308,92010,156,106,262,29,7,298,52.34899329,35.5704698,87.91946309,9.731543624,2.348993289,776000
309,92011,379,365,744,132,75,951,39.85278654,38.38065195,78.23343849,13.88012618,7.886435331,924700
310,92014,224,72,296,41,18,355,63.09859155,20.28169014,83.38028169,11.54929577,5.070422535,1827000
311,92019,918,1420,2338,1187,1669,5194,17.67423951,27.33923758,45.01347709,22.85329226,32.13323065,576700
312,92020,841,1369,2210,1343,1880,5433,15.47947727,25.1978649,40.67734217,24.71930793,34.6033499,576200
313,92021,426,779,1205,858,1439,3502,12.16447744,22.24443175,34.40890919,24.50028555,41.09080525,469100
314,92024,1280,1370,2650,688,475,3813,33.56936795,35.92971414,69.49908209,18.04353527,12.45738264,1063400
315,92025,807,1439,2246,1125,1342,4713,17.12285169,30.53256949,47.65542118,23.8701464,28.47443242,558600
316,92026,572,1039,1611,1002,1364,3977,14.38270053,26.12522002,40.50792054,25.19487051,34.29720895,539900
317,92027,714,1235,1949,1255,1663,4867,14.67022807,25.37497432,40.04520238,25.78590507,34.16889254,493300
318,92028,508,833,1341,671,848,2860,17.76223776,29.12587413,46.88811189,23.46153846,29.65034965,627900
319,92029,163,206,369,125,162,656,24.84756098,31.40243902,56.25,19.05487805,24.69512195,690900
320,92036,80,135,215,170,351,736,10.86956522,18.3423913,29.21195652,23.09782609,47.69021739,425900
321,92037,728,505,1233,207,112,1552,46.90721649,32.53865979,79.44587629,13.33762887,7.216494845,1614900
322,92040,542,942,1484,812,923,3219,16.83752718,29.26374651,46.10127369,25.22522523,28.67350109,540200
323,92054,275,533,808,603,712,2123,12.95336788,25.1059821,38.05934998,28.40320301,33.53744701,648800
324,92056,698,1118,1816,969,958,3743,18.6481432,29.86908897,48.51723217,25.88832487,25.59444296,583700
325,92057,1096,1559,2655,1286,1615,5556,19.72642189,28.05975522,47.78617711,23.14614831,29.06767459,530600
326,92058,413,664,1077,576,793,2446,16.88470973,27.14636141,44.03107114,23.54865086,32.420278,510400
327,92059,0,7,7,16,25,48,0,14.58333333,14.58333333,33.33333333,52.08333333,234200
328,92061,4,32,36,31,55,122,3.278688525,26.2295082,29.50819672,25.40983607,45.08196721,611500
329,92064,2412,2821,5233,1917,1743,8893,27.12245586,31.72157877,58.84403463,21.55628022,19.59968515,767500
330,92065,471,821,1292,601,709,2602,18.10146042,31.55265181,49.65411222,23.09761722,27.24827056,593100
331,92067,338,210,548,46,29,623,54.25361156,33.70786517,87.96147673,7.383627608,4.654895666,2000000
332,92069,1212,1373,2585,1041,1054,4680,25.8974359,29.33760684,55.23504274,22.24358974,22.52136752,569500
333,92070,4,7,11,3,5,19,21.05263158,36.84210526,57.89473684,15.78947368,26.31578947,335700
334,92071,1113,1373,2486,882,806,4174,26.66506948,32.89410637,59.55917585,21.13080977,19.31001437,524100
335,92075,452,317,769,119,76,964,46.8879668,32.88381743,79.77178423,12.34439834,7.883817427,1442900
336,92078,1559,1742,3301,1116,849,5266,29.60501329,33.08013673,62.68515002,21.19255602,16.12229396,665300
337,92081,165,206,371,133,155,659,25.03793627,31.25948407,56.29742033,20.18209408,23.52048558,599400
338,92082,142,325,467,411,729,1607,8.836341008,20.22401991,29.06036092,25.57560672,45.36403236,620700
339,92083,710,1173,1883,1027,1219,4129,17.19544684,28.40881569,45.60426253,24.87285057,29.5228869,467600
340,92084,324,725,1049,862,1174,3085,10.50243112,23.50081037,34.00324149,27.94165316,38.05510535,600600
341,92086,5,28,33,27,50,110,4.545454545,25.45454545,30,24.54545455,45.45454545,265800
342,92101,180,295,475,245,303,1023,17.59530792,28.83675464,46.43206256,23.94916911,29.61876833,626000
343,92102,466,1062,1528,1068,1534,4130,11.28329298,25.71428571,36.99757869,25.85956416,37.14285714,477100
344,92103,483,477,960,367,346,1673,28.87029289,28.51165571,57.3819486,21.93664077,20.68141064,835300
345,92104,191,171,362,108,108,578,33.0449827,29.58477509,62.62975779,18.68512111,18.68512111,679300
346,92105,373,813,1186,934,1676,3796,9.826132771,21.41728135,31.24341412,24.60484721,44.15173867,459200
347,92106,526,746,1272,552,588,2412,21.80762852,30.92868988,52.73631841,22.88557214,24.37810945,1070000
348,92107,374,355,729,200,125,1054,35.48387097,33.68121442,69.16508539,18.97533207,11.85958254,982300
349,92108,23,43,66,24,23,113,20.3539823,38.05309735,58.40707965,21.23893805,20.3539823,469300
350,92109,566,460,1026,266,201,1493,37.91024782,30.81044876,68.72069658,17.81647689,13.46282652,962000
351,92110,466,433,899,321,321,1541,30.24010383,28.09863725,58.33874108,20.83062946,20.83062946,688800
352,92111,661,797,1458,684,985,3127,21.13847138,25.48768788,46.62615926,21.87400064,31.4998401,604600
353,92113,182,558,740,845,1874,3459,5.261636311,16.13183001,21.39346632,24.42902573,54.17750795,406600
354,92114,648,1090,1738,975,1310,4023,16.10738255,27.0942083,43.20159085,24.23564504,32.56276411,461500
355,92115,526,884,1410,899,1234,3543,14.84617556,24.95060683,39.79678239,25.37397686,34.82924076,580800
356,92116,183,219,402,149,188,739,24.7631935,29.63464141,54.39783491,20.1623816,25.43978349,690400
357,92117,486,830,1316,748,805,2869,16.93970024,28.92994075,45.86964099,26.07180202,28.05855699,690000
358,92118,576,484,1060,211,121,1392,41.37931034,34.77011494,76.14942529,15.15804598,8.692528736,1656900
359,92119,480,509,989,287,208,1484,32.34501348,34.29919137,66.64420485,19.33962264,14.01617251,632500
360,92120,961,848,1809,512,483,2804,34.2724679,30.2425107,64.5149786,18.2596291,17.2253923,654100
361,92121,101,206,307,173,184,664,15.21084337,31.02409639,46.23493976,26.05421687,27.71084337,821100
362,92122,782,477,1259,331,314,1904,41.07142857,25.05252101,66.12394958,17.38445378,16.49159664,780000
363,92123,440,466,906,341,413,1660,26.5060241,28.07228916,54.57831325,20.54216867,24.87951807,600900
364,92124,561,758,1319,564,551,2434,23.04847987,31.14215283,54.1906327,23.17173377,22.63763353,704400
365,92126,1211,1153,2364,672,620,3656,33.12363239,31.53719912,64.66083151,18.38074398,16.95842451,599500
366,92127,2639,1490,4129,606,355,5090,51.84675835,29.27308448,81.11984283,11.90569745,6.974459725,914200
367,92128,1369,1029,2398,469,269,3136,43.65433673,32.8125,76.46683673,14.95535714,8.577806122,681900
368,92129,2283,1486,3769,646,380,4795,47.61209593,30.99061522,78.60271116,13.47236705,7.924921794,815300
369,92130,3301,1674,4975,578,305,5858,56.3502902,28.57630591,84.92659611,9.866848754,5.206555138,1189300
370,92131,1607,916,2523,386,196,3105,51.75523349,29.50080515,81.25603865,12.431562,6.312399356,885500
371,92139,456,602,1058,517,623,2198,20.74613285,27.38853503,48.13466788,23.52138308,28.34394904,466100
372,92154,869,1745,2614,1700,2605,6919,12.55961844,25.22040757,37.78002602,24.57002457,37.64994941,477900
373,92173,166,343,509,518,1035,2062,8.050436469,16.6343356,24.68477207,25.12124151,50.19398642,388700
374,92201,578,1277,1855,1539,2549,5943,9.725727747,21.48746424,31.21319199,25.89601212,42.89079589,272400
375,92203,210,374,584,419,542,1545,13.59223301,24.20711974,37.79935275,27.1197411,35.08090615,368900
376,92210,90,84,174,63,55,292,30.82191781,28.76712329,59.5890411,21.57534247,18.83561644,750700
377,92211,93,108,201,80,112,393,23.66412214,27.48091603,51.14503817,20.3562341,28.49872774,400000
378,92220,99,337,436,462,1153,2051,4.826913701,16.43100926,21.25792296,22.52559727,56.21647977,259600
379,92223,1332,2190,3522,2042,2250,7814,17.04632711,28.02661889,45.07294599,26.13258254,28.79447146,354000
380,92225,121,293,414,324,678,1416,8.54519774,20.6920904,29.23728814,22.88135593,47.88135593,165000
381,92227,425,759,1184,842,1193,3219,13.20285803,23.57875116,36.7816092,26.15719167,37.06119913,226700
382,92230,8,24,32,41,81,154,5.194805195,15.58441558,20.77922078,26.62337662,52.5974026,211900
383,92231,319,797,1116,988,2223,4327,7.372313381,18.4192281,25.79154148,22.83337185,51.37508667,233300
384,92233,48,128,176,164,223,563,8.525754885,22.73534636,31.26110124,29.12966252,39.60923623,158400
385,92234,454,958,1412,1026,1643,4081,11.12472433,23.47463857,34.5993629,25.14089684,40.25974026,325200
386,92236,446,1034,1480,1128,1903,4511,9.886943028,22.92174684,32.80868987,25.00554201,42.18576812,262300
387,92239,1,2,3,5,8,16,6.25,12.5,18.75,31.25,50,112500
388,92240,246,664,910,813,1649,3372,7.295373665,19.6915777,26.98695136,24.11032028,48.90272835,230300
389,92243,859,1505,2364,1330,1916,5610,15.31194296,26.82709447,42.13903743,23.70766488,34.15329768,216700
390,92249,146,230,376,184,238,798,18.29573935,28.82205514,47.11779449,23.05764411,29.8245614,220200
391,92250,127,250,377,210,202,789,16.09632446,31.68567807,47.78200253,26.61596958,25.60202788,234300
392,92251,465,736,1201,562,498,2261,20.56612119,32.55196816,53.11808934,24.85625829,22.02565237,271600
393,92252,39,66,105,63,138,306,12.74509804,21.56862745,34.31372549,20.58823529,45.09803922,217900
394,92253,357,775,1132,806,1067,3005,11.88019967,25.79034942,37.67054908,26.82196339,35.50748752,453600
395,92254,71,160,231,222,505,958,7.411273486,16.70146138,24.11273486,23.17327766,52.71398747,160400
396,92256,15,16,31,24,25,80,18.75,20,38.75,30,31.25,183300
397,92257,7,4,11,9,12,32,21.875,12.5,34.375,28.125,37.5,57800
398,92260,714,890,1604,536,493,2633,27.11735663,33.80174706,60.91910368,20.35700722,18.7238891,363400
399,92262,299,406,705,349,503,1557,19.20359666,26.07578677,45.27938343,22.41490045,32.30571612,447800
400,92264,190,342,532,268,335,1135,16.74008811,30.13215859,46.8722467,23.6123348,29.5154185,386800
401,92270,115,131,246,108,116,470,24.46808511,27.87234043,52.34042553,22.9787234,24.68085106,570400
402,92273,14,44,58,60,122,240,5.833333333,18.33333333,24.16666667,25,50.83333333,158800
403,92274,158,582,740,823,1478,3041,5.195659323,19.1384413,24.33410062,27.06346597,48.60243341,113200
404,92275,28,122,150,156,313,619,4.523424879,19.7092084,24.23263328,25.20193861,50.56542811,145600
405,92276,37,58,95,63,123,281,13.16725979,20.6405694,33.80782918,22.41992883,43.77224199,206000
406,92277,163,393,556,421,717,1694,9.622195986,23.19952774,32.82172373,24.85242031,42.32585596,158900
407,92281,16,42,58,66,116,240,6.666666667,17.5,24.16666667,27.5,48.33333333,160600
408,92284,157,363,520,403,610,1533,10.24135682,23.67906067,33.92041748,26.28832355,39.79125897,225100
409,92285,5,13,18,16,24,58,8.620689655,22.4137931,31.03448276,27.5862069,41.37931034,157100
410,92301,176,473,649,727,1628,3004,5.85885486,15.74567244,21.6045273,24.20106525,54.19440746,238600
411,92307,340,706,1046,872,1650,3568,9.529147982,19.78699552,29.3161435,24.43946188,46.24439462,301700
412,92308,378,929,1307,1007,1642,3956,9.555106168,23.48331648,33.03842265,25.45500506,41.5065723,282100
413,92309,0,4,4,14,37,55,0,7.272727273,7.272727273,25.45454545,67.27272727,86300
414,92311,192,556,748,759,1825,3332,5.762304922,16.68667467,22.44897959,22.77911164,54.77190876,144900
415,92313,187,427,614,508,842,1964,9.521384929,21.7413442,31.26272912,25.86558045,42.87169043,378100
416,92314,63,85,148,74,107,329,19.14893617,25.83586626,44.98480243,22.49240122,32.52279635,307100
417,92315,81,192,273,188,246,707,11.45685997,27.15700141,38.61386139,26.59123055,34.79490806,467800
418,92316,333,749,1082,897,1436,3415,9.751098097,21.93265007,31.68374817,26.26647145,42.04978038,339100
419,92320,137,182,319,164,115,598,22.909699,30.43478261,53.34448161,27.42474916,19.23076923,279200
420,92324,537,1289,1826,1613,2765,6204,8.655705996,20.77691812,29.43262411,25.99935525,44.56802063,326000
421,92325,22,42,64,70,116,250,8.8,16.8,25.6,28,46.4,278800
422,92327,7,14,21,11,24,56,12.5,25,37.5,19.64285714,42.85714286,151700
423,92335,682,1797,2479,2175,3764,8418,8.101686861,21.34711333,29.44880019,25.83749109,44.71370872,344200
424,92336,1629,2611,4240,2358,2988,9586,16.99353223,27.23763822,44.23117046,24.59837263,31.17045692,460100
425,92337,508,1205,1713,1148,1499,4360,11.65137615,27.63761468,39.28899083,26.33027523,34.38073394,403600
426,92339,26,19,45,7,5,57,45.61403509,33.33333333,78.94736842,12.28070175,8.771929825,335700
427,92342,59,158,217,171,226,614,9.609120521,25.73289902,35.34201954,27.85016287,36.80781759,266100
428,92344,240,623,863,745,1034,2642,9.084027252,23.58062074,32.66464799,28.1983346,39.13701741,345700
429,92345,815,2116,2931,2602,4640,10173,8.011402733,20.80015728,28.81156001,25.57750909,45.6109309,277100
430,92346,681,1545,2226,1609,2350,6185,11.0105093,24.97978981,35.99029911,26.01455133,37.99514956,367300
431,92352,147,305,452,312,358,1122,13.10160428,27.18360071,40.28520499,27.80748663,31.90730838,457800
432,92354,95,81,176,48,88,312,30.44871795,25.96153846,56.41025641,15.38461538,28.20512821,411400
433,92356,300,651,951,618,872,2441,12.29004506,26.66939779,38.95944285,25.31749283,35.72306432,169100
434,92359,44,50,94,56,79,229,19.2139738,21.83406114,41.04803493,24.45414847,34.49781659,341600
435,92363,21,105,126,128,193,447,4.697986577,23.48993289,28.18791946,28.63534676,43.17673378,125400
436,92365,3,11,14,9,23,46,6.52173913,23.91304348,30.43478261,19.56521739,50,117600
437,92368,104,321,425,398,623,1446,7.192254495,22.19917012,29.39142462,27.5242047,43.08437068,259800
438,92371,141,415,556,490,673,1719,8.202443281,24.14194299,32.34438627,28.50494474,39.15066899,272700
439,92372,23,52,75,62,100,237,9.70464135,21.94092827,31.64556962,26.16033755,42.19409283,294100
440,92373,1284,1391,2675,1123,1107,4905,26.17737003,28.35881753,54.53618756,22.8950051,22.56880734,530800
441,92374,1184,1576,2760,1306,1471,5537,21.38342062,28.46306664,49.84648727,23.58677984,26.56673289,413600
442,92376,648,1464,2112,1817,3519,7448,8.700322234,19.65628357,28.3566058,24.39581096,47.24758324,332100
443,92377,349,813,1162,790,1100,3052,11.43512451,26.63826999,38.0733945,25.88466579,36.04193971,418300
444,92391,6,28,34,46,63,143,4.195804196,19.58041958,23.77622378,32.16783217,44.05594406,277100
445,92392,641,1337,1978,1174,1799,4951,12.94687942,27.00464553,39.95152494,23.71238134,36.33609372,276900
446,92394,187,515,702,794,1734,3230,5.789473684,15.94427245,21.73374613,24.58204334,53.68421053,261300
447,92395,746,1470,2216,1826,3745,7787,9.580069346,18.87761654,28.45768589,23.44933864,48.09297547,255100
448,92397,30,34,64,32,34,130,23.07692308,26.15384615,49.23076923,24.61538462,26.15384615,360900
449,92399,818,1339,2157,1199,1530,4886,16.74171101,27.40483013,44.14654114,24.53950061,31.31395825,368400
450,92404,525,1264,1789,1252,2228,5269,9.963940027,23.9893718,33.95331182,23.7616246,42.28506358,289900
451,92405,212,578,790,755,1319,2864,7.402234637,20.18156425,27.58379888,26.36173184,46.05446927,277800
452,92407,852,1552,2404,1564,2119,6087,13.99704288,25.49696074,39.49400361,25.69410218,34.8118942,367300
453,92408,149,409,558,523,1029,2110,7.061611374,19.38388626,26.44549763,24.78672986,48.76777251,304900
454,92410,442,1002,1444,949,1690,4083,10.8253735,24.54077884,35.36615234,23.24271369,41.39113397,207500
455,92411,249,558,807,748,1223,2778,8.963282937,20.08639309,29.04967603,26.92584593,44.02447804,238400
456,92501,279,595,874,610,921,2405,11.6008316,24.74012474,36.34095634,25.36382536,38.2952183,358700
457,92503,1132,2192,3324,2139,2756,8219,13.77296508,26.66991118,40.44287626,26.02506388,33.53205986,426000
458,92504,584,1240,1824,1096,1384,4304,13.56877323,28.81040892,42.37918216,25.46468401,32.15613383,391600
459,92505,353,768,1121,900,1443,3464,10.19053118,22.17090069,32.36143187,25.98152425,41.65704388,408100
460,92506,860,1309,2169,1083,1498,4750,18.10526316,27.55789474,45.66315789,22.8,31.53684211,503700
461,92507,626,953,1579,815,1194,3588,17.44704571,26.56075808,44.00780379,22.71460424,33.27759197,396100
462,92508,1001,1075,2076,650,572,3298,30.35172832,32.59551243,62.94724075,19.70891449,17.34384475,536600
463,92509,612,1634,2246,2093,3627,7966,7.682651268,20.51217675,28.19482802,26.2741652,45.53100678,391900
464,92530,505,1117,1622,1430,2261,5313,9.504987766,21.02390363,30.5288914,26.91511387,42.55599473,368200
465,92532,551,843,1394,690,679,2763,19.94209193,30.51031488,50.4524068,24.97285559,24.5747376,413400
466,92536,18,33,51,29,29,109,16.51376147,30.27522936,46.78899083,26.60550459,26.60550459,374100
467,92539,26,74,100,86,139,325,8,22.76923077,30.76923077,26.46153846,42.76923077,242300
468,92543,334,844,1178,966,2067,4211,7.931607694,20.04274519,27.97435289,22.93991926,49.08572786,169000
469,92544,287,717,1004,825,1502,3331,8.616031222,21.52506755,30.14109877,24.76733714,45.09156409,271700
470,92545,314,603,917,712,1111,2740,11.45985401,22.00729927,33.46715328,25.98540146,40.54744526,252000
471,92549,29,56,85,40,45,170,17.05882353,32.94117647,50,23.52941176,26.47058824,400300
472,92551,610,1039,1649,1030,1372,4051,15.05801037,25.64798815,40.70599852,25.42582078,33.8681807,332400
473,92553,550,1337,1887,1718,3527,7132,7.711721817,18.74649467,26.45821649,24.08861469,49.45316882,321800
474,92555,395,870,1265,1050,1602,3917,10.08424815,22.21087567,32.29512382,26.80622926,40.89864692,403300
475,92557,610,1240,1850,1298,1931,5079,12.01023824,24.41425477,36.42449301,25.55621185,38.01929514,362200
476,92562,1496,2030,3526,1536,1188,6250,23.936,32.48,56.416,24.576,19.008,478500
477,92563,1930,2595,4525,1745,1251,7521,25.66148119,34.50339051,60.16487169,23.2017019,16.63342641,459800
478,92567,123,303,426,311,383,1120,10.98214286,27.05357143,38.03571429,27.76785714,34.19642857,379400
479,92570,457,1251,1708,1469,2676,5853,7.807961729,21.37365454,29.18161627,25.09824022,45.72014352,326200
480,92571,752,1322,2074,1471,2197,5742,13.09648206,23.02333682,36.11981888,25.61825148,38.26192964,336100
481,92582,112,320,432,459,773,1664,6.730769231,19.23076923,25.96153846,27.58413462,46.45432692,339000
482,92583,527,1150,1677,1162,1817,4656,11.31872852,24.69931271,36.01804124,24.95704467,39.02491409,251700
483,92584,1011,1663,2674,1399,1335,5408,18.69452663,30.75073964,49.44526627,25.86908284,24.68565089,422000
484,92585,472,979,1451,871,1232,3554,13.28081035,27.54642656,40.82723692,24.50759707,34.66516601,371400
485,92586,199,367,566,338,411,1315,15.13307985,27.90874525,43.0418251,25.70342205,31.25475285,276200
486,92587,30,55,85,52,86,223,13.4529148,24.66367713,38.11659193,23.31838565,38.56502242,442700
487,92590,830,1494,2324,1287,1633,5244,15.82761251,28.48970252,44.31731503,24.5423341,31.14035088,1071800
488,92591,932,1243,2175,784,643,3602,25.87451416,34.50860633,60.38312049,21.76568573,17.85119378,501600
489,92592,2315,2702,5017,1494,1119,7630,30.34076016,35.41284404,65.75360419,19.58060288,14.66579292,522400
490,92595,373,725,1098,845,1112,3055,12.20949264,23.73158756,35.9410802,27.65957447,36.39934534,417300
491,92596,791,1086,1877,727,697,3301,23.96243563,32.89912148,56.8615571,22.0236292,21.11481369,475400
492,92602,1210,713,1923,302,196,2421,49.97934738,29.45064023,79.42998761,12.47418422,8.09582817,933600
493,92603,877,480,1357,194,130,1681,52.17132659,28.55443189,80.72575848,11.54074955,7.733491969,1303200
494,92604,1643,1103,2746,509,404,3659,44.90297896,30.14484832,75.04782728,13.91090462,11.04126811,818400
495,92606,469,362,831,228,187,1246,37.64044944,29.0529695,66.69341894,18.29855538,15.00802568,853800
496,92612,657,463,1120,191,164,1475,44.54237288,31.38983051,75.93220339,12.94915254,11.11864407,789000
497,92614,620,509,1129,272,254,1655,37.46223565,30.75528701,68.21752266,16.43504532,15.34743202,789500
498,92618,1575,1236,2811,651,438,3900,40.38461538,31.69230769,72.07692308,16.69230769,11.23076923,960800
499,92620,3202,1911,5113,783,539,6435,49.75912976,29.6969697,79.45609946,12.16783217,8.376068376,982000
500,92624,46,53,99,33,36,168,27.38095238,31.54761905,58.92857143,19.64285714,21.42857143,913400
501,92625,140,115,255,72,45,372,37.6344086,30.91397849,68.5483871,19.35483871,12.09677419,2000000
502,92626,650,901,1551,711,726,2988,21.75368139,30.15394913,51.90763052,23.79518072,24.29718876,842500
503,92627,383,538,921,527,617,2065,18.5472155,26.05326877,44.60048426,25.52058111,29.87893462,842100
504,92629,238,179,417,100,82,599,39.73288815,29.88313856,69.61602671,16.69449082,13.68948247,981600
505,92630,1161,1082,2243,754,970,3967,29.2664482,27.27501891,56.5414671,19.00680615,24.45172675,694800
506,92646,1280,1100,2380,563,320,3263,39.22770457,33.71130861,72.93901318,17.25406068,9.806926142,814900
507,92647,1379,1458,2837,899,886,4622,29.83556902,31.54478581,61.38035482,19.45045435,19.16919083,793300
508,92648,949,799,1748,416,311,2475,38.34343434,32.28282828,70.62626263,16.80808081,12.56565657,985800
509,92649,497,510,1007,288,211,1506,33.00132802,33.86454183,66.86586985,19.12350598,14.01062417,885000
510,92651,549,447,996,197,98,1291,42.52517428,34.62432223,77.14949651,15.25948877,7.591014717,2000000
511,92653,314,326,640,205,206,1051,29.87630828,31.01807802,60.8943863,19.50523311,19.60038059,771800
512,92655,231,199,430,132,177,739,31.25845737,26.92828146,58.18673884,17.86197564,23.95128552,583300
513,92656,1501,1288,2789,614,366,3769,39.82488724,34.17352083,73.99840807,16.29079331,9.71079862,679300
514,92657,152,68,220,24,20,264,57.57575758,25.75757576,83.33333333,9.090909091,7.575757576,2000000
515,92660,640,612,1252,315,257,1824,35.0877193,33.55263158,68.64035088,17.26973684,14.08991228,1905400
516,92661,81,52,133,39,11,183,44.26229508,28.41530055,72.67759563,21.31147541,6.010928962,2000000
517,92663,512,603,1115,312,277,1704,30.04694836,35.38732394,65.4342723,18.30985915,16.25586854,1590000
518,92672,445,542,987,380,359,1726,25.78215527,31.40208575,57.18424102,22.01622248,20.7995365,980200
519,92673,1175,1010,2185,491,294,2970,39.56228956,34.00673401,73.56902357,16.53198653,9.898989899,972200
520,92675,1128,1509,2637,1192,1247,5076,22.22222222,29.72813239,51.95035461,23.48305753,24.56658786,770000
521,92677,990,854,1844,489,332,2665,37.14821764,32.04502814,69.19324578,18.34896811,12.45778612,909500
522,92678,10,11,21,13,6,40,25,27.5,52.5,32.5,15,777000
523,92679,338,275,613,138,100,851,39.71797885,32.31492362,72.03290247,16.21621622,11.75088132,970200
524,92683,1763,1692,3455,1074,1307,5836,30.20904729,28.99246059,59.20150788,18.40301576,22.39547635,651200
525,92688,1700,1433,3133,701,479,4313,39.41571992,33.22513332,72.64085323,16.25318804,11.10595873,673400
526,92691,1574,1596,3170,1016,958,5144,30.59875583,31.02643857,61.6251944,19.75116641,18.62363919,750800
527,92692,1272,911,2183,466,332,2981,42.67024488,30.56021469,73.23045958,15.63233814,11.13720228,795500
528,92694,1251,967,2218,388,200,2806,44.58303635,34.46186743,79.04490378,13.82751247,7.127583749,844700
529,92701,994,1539,2533,1488,2054,6075,16.36213992,25.33333333,41.69547325,24.49382716,33.81069959,521700
530,92703,318,612,930,773,1670,3373,9.427809072,18.14408538,27.57189446,22.91728432,49.51082123,486000
531,92704,834,1736,2570,1970,3014,7554,11.04050834,22.98120201,34.02171035,26.0788986,39.89939105,534800
532,92705,1231,1244,2475,1066,1319,4860,25.32921811,25.59670782,50.92592593,21.93415638,27.1399177,914900
533,92706,379,904,1283,931,1183,3397,11.15690315,26.61171622,37.76861937,27.40653518,34.82484545,673300
534,92707,398,936,1334,1188,2030,4552,8.74340949,20.56239016,29.30579965,26.09841828,44.59578207,539700
535,92708,2267,1586,3853,904,851,5608,40.42439372,28.2810271,68.70542083,16.11982882,15.17475036,816900
536,92780,553,999,1552,975,1587,4114,13.44190569,24.28293632,37.724842,23.69956247,38.57559553,669400
537,92782,832,765,1597,373,271,2241,37.12628291,34.13654618,71.26282909,16.6443552,12.09281571,879300
538,92801,508,990,1498,1095,1669,4262,11.91928672,23.22853121,35.14781793,25.6921633,39.16001877,543200
539,92802,193,513,706,641,1158,2505,7.704590818,20.47904192,28.18363273,25.58882236,46.22754491,577500
540,92804,1072,1779,2851,1788,2416,7055,15.19489724,25.21615875,40.41105599,25.34372785,34.24521616,594400
541,92805,459,1112,1571,1354,2447,5372,8.544303797,20.69992554,29.24422934,25.20476545,45.55100521,583800
542,92806,268,729,997,884,1347,3228,8.302354399,22.58364312,30.88599752,27.38537794,41.72862454,623300
543,92807,1127,785,1912,495,353,2760,40.83333333,28.44202899,69.27536232,17.93478261,12.78985507,731100
544,92808,616,679,1295,272,139,1706,36.10785463,39.8007034,75.90855803,15.94372802,8.147713951,807100
545,92821,991,931,1922,547,515,2984,33.21045576,31.1997319,64.41018767,18.3310992,17.25871314,700900
546,92831,835,753,1588,512,676,2776,30.07925072,27.12536023,57.20461095,18.44380403,24.35158501,676300
547,92832,313,363,676,351,428,1455,21.51202749,24.94845361,46.4604811,24.12371134,29.41580756,615300
548,92833,1289,1170,2459,735,908,4102,31.42369576,28.52267187,59.94636763,17.91808874,22.13554364,686700
549,92835,563,428,991,210,189,1390,40.50359712,30.79136691,71.29496403,15.10791367,13.5971223,831100
550,92840,1033,1100,2133,810,916,3859,26.7685929,28.50479399,55.27338689,20.98989375,23.73671936,590900
551,92841,637,778,1415,609,856,2880,22.11805556,27.01388889,49.13194444,21.14583333,29.72222222,609900
552,92843,1041,1191,2232,878,1111,4221,24.66240227,28.21606254,52.87846482,20.80075811,26.32077707,570200
553,92844,888,704,1592,421,537,2550,34.82352941,27.60784314,62.43137255,16.50980392,21.05882353,545400
554,92845,949,611,1560,309,198,2067,45.91194969,29.55974843,75.47169811,14.94920174,9.579100145,668900
555,92860,634,978,1612,815,820,3247,19.52571605,30.12011087,49.64582692,25.10009239,25.25408069,595300
556,92861,489,611,1100,427,371,1898,25.76396207,32.19178082,57.95574289,22.49736565,19.54689146,1287100
557,92865,135,173,308,159,228,695,19.42446043,24.89208633,44.31654676,22.87769784,32.8057554,652400
558,92866,68,99,167,94,171,432,15.74074074,22.91666667,38.65740741,21.75925926,39.58333333,722200
559,92867,140,380,520,423,603,1546,9.055627426,24.57956016,33.63518758,27.36093144,39.00388098,780900
560,92868,119,231,350,278,374,1002,11.8762475,23.05389222,34.93013972,27.74451098,37.3253493,531900
561,92869,866,1182,2048,908,857,3813,22.7117755,30.99921322,53.71098872,23.81327039,22.47574089,770700
562,92870,2034,1672,3706,1148,1105,5959,34.13324383,28.05839906,62.19164289,19.26497735,18.54337976,696700
563,92879,684,869,1553,829,1061,3443,19.86639559,25.23961661,45.1060122,24.07783909,30.81614871,452900
564,92880,2280,2540,4820,1651,1280,7751,29.41555928,32.76996517,62.18552445,21.30047736,16.51399819,601700
565,92881,1069,1208,2277,634,512,3423,31.22991528,35.29068069,66.52059597,18.52176453,14.9576395,615000
566,92882,1210,1972,3182,1501,1681,6364,19.01319925,30.98680075,50,23.5857951,26.4142049,521000
567,92883,598,675,1273,556,503,2332,25.6432247,28.94511149,54.58833619,23.84219554,21.56946827,538500
568,92886,1261,1053,2314,576,400,3290,38.32826748,32.00607903,70.3343465,17.50759878,12.15805471,864700
569,92887,436,413,849,179,120,1148,37.97909408,35.97560976,73.95470383,15.59233449,10.45296167,903900
570,93001,493,686,1179,540,791,2510,19.64143426,27.33067729,46.97211155,21.51394422,31.51394422,630400
571,93003,894,1159,2053,1007,1088,4148,21.55255545,27.94117647,49.49373192,24.27675988,26.2295082,617700
572,93004,175,208,383,194,276,853,20.51582649,24.38452521,44.9003517,22.74325909,32.35638921,608100
573,93010,776,998,1774,752,781,3307,23.46537647,30.17840943,53.64378591,22.73964318,23.61657091,662300
574,93012,751,693,1444,414,398,2256,33.28900709,30.71808511,64.0070922,18.35106383,17.64184397,657700
575,93013,154,263,417,253,307,977,15.76253838,26.91914023,42.68167861,25.89559877,31.42272262,822400
576,93015,51,123,174,151,210,535,9.53271028,22.99065421,32.52336449,28.22429907,39.25233645,456600
577,93021,831,827,1658,616,617,2891,28.74437911,28.60601868,57.35039779,21.30750605,21.34209616,690900
578,93022,33,64,97,53,57,207,15.94202899,30.9178744,46.85990338,25.60386473,27.53623188,610500
579,93023,201,298,499,291,317,1107,18.15718157,26.91960253,45.0767841,26.28726287,28.63595303,692700
580,93030,465,1311,1776,1553,2686,6015,7.730673317,21.79551122,29.52618454,25.81878637,44.65502909,530000
581,93033,598,1746,2344,2479,4376,9199,6.500706599,18.98032395,25.48103055,26.94858137,47.57038809,442700
582,93035,194,333,527,330,448,1305,14.86590038,25.51724138,40.38314176,25.28735632,34.32950192,632800
583,93036,582,1237,1819,1330,2026,5175,11.24637681,23.90338164,35.14975845,25.70048309,39.14975845,527700
584,93040,14,18,32,33,69,134,10.44776119,13.43283582,23.88059701,24.62686567,51.49253731,393500
585,93041,102,177,279,271,490,1040,9.807692308,17.01923077,26.82692308,26.05769231,47.11538462,446800
586,93060,238,646,884,827,1122,2833,8.400988352,22.80268267,31.20367102,29.19166961,39.60465937,446700
587,93063,559,912,1471,696,669,2836,19.71086037,32.15796897,51.86882934,24.5416079,23.58956276,626900
588,93065,2649,3848,6497,3242,4301,14040,18.86752137,27.40740741,46.27492877,23.09116809,30.63390313,642900
589,93066,106,137,243,138,133,514,20.62256809,26.6536965,47.27626459,26.84824903,25.87548638,1068500
590,93067,8,3,11,7,3,21,38.0952381,14.28571429,52.38095238,33.33333333,14.28571429,1875000
591,93101,134,266,400,301,386,1087,12.3275069,24.47102116,36.79852806,27.69089236,35.51057958,905500
592,93103,183,352,535,384,592,1511,12.11118465,23.29583058,35.40701522,25.41363336,39.17935142,1117000
593,93105,217,184,401,138,173,712,30.47752809,25.84269663,56.32022472,19.38202247,24.29775281,1180200
594,93108,241,63,304,28,5,337,71.51335312,18.69436202,90.20771513,8.308605341,1.483679525,2000000
595,93109,155,186,341,174,181,696,22.27011494,26.72413793,48.99425287,25,26.00574713,1413400
596,93110,509,613,1122,413,315,1850,27.51351351,33.13513514,60.64864865,22.32432432,17.02702703,875700
597,93111,308,193,501,121,99,721,42.7184466,26.76837725,69.48682386,16.78224688,13.73092926,961100
598,93117,798,717,1515,480,480,2475,32.24242424,28.96969697,61.21212121,19.39393939,19.39393939,838300
599,93201,48,94,142,121,175,438,10.95890411,21.46118721,32.42009132,27.62557078,39.9543379,91000
600,93202,60,127,187,176,272,635,9.448818898,20,29.4488189,27.71653543,42.83464567,187500
601,93203,323,718,1041,809,1372,3222,10.0248293,22.28429547,32.30912477,25.10862818,42.58224705,192800
602,93204,63,222,285,242,735,1262,4.99207607,17.5911252,22.58320127,19.17591125,58.24088748,180200
603,93206,5,38,43,45,127,215,2.325581395,17.6744186,20,20.93023256,59.06976744,152200
604,93210,147,284,431,368,759,1558,9.435173299,18.22849807,27.66367137,23.62002567,48.71630295,203100
605,93212,171,373,544,420,745,1709,10.00585138,21.82562902,31.8314804,24.57577531,43.59274429,176400
606,93215,1049,1771,2820,1505,1989,6314,16.61387393,28.04878049,44.66265442,23.83592018,31.5014254,215100
607,93218,0,11,11,19,52,82,0,13.41463415,13.41463415,23.17073171,63.41463415,134500
608,93219,46,171,217,257,561,1035,4.444444444,16.52173913,20.96618357,24.83091787,54.20289855,162500
609,93221,155,313,468,379,484,1331,11.64537941,23.51615327,35.16153268,28.47483095,36.36363636,278600
610,93222,10,13,23,4,6,33,30.3030303,39.39393939,69.6969697,12.12121212,18.18181818,282500
611,93223,81,253,334,332,641,1307,6.197398623,19.35730681,25.55470543,25.40168324,49.04361132,189100
612,93224,7,12,19,13,17,49,14.28571429,24.48979592,38.7755102,26.53061224,34.69387755,152200
613,93230,1091,1836,2927,1369,1638,5934,18.38557465,30.94034378,49.32591844,23.07044152,27.60364004,252300
614,93234,18,78,96,161,490,747,2.409638554,10.44176707,12.85140562,21.55287818,65.5957162,190000
615,93235,27,87,114,84,141,339,7.96460177,25.66371681,33.62831858,24.77876106,41.59292035,175600
616,93240,42,103,145,124,269,538,7.80669145,19.14498141,26.95167286,23.04832714,50,177900
617,93241,75,175,250,309,701,1260,5.952380952,13.88888889,19.84126984,24.52380952,55.63492063,147600
618,93242,15,50,65,65,219,349,4.297994269,14.32664756,18.62464183,18.62464183,62.75071633,264100
619,93243,42,94,136,108,120,364,11.53846154,25.82417582,37.36263736,29.67032967,32.96703297,359400
620,93244,42,48,90,60,81,231,18.18181818,20.77922078,38.96103896,25.97402597,35.06493506,177800
621,93245,840,1163,2003,904,967,3874,21.68301497,30.02065049,51.70366546,23.33505421,24.96128033,261400
622,93247,240,545,785,542,714,2041,11.7589417,26.70259677,38.46153846,26.55561,34.98285154,208800
623,93249,43,93,136,128,164,428,10.04672897,21.72897196,31.77570093,29.90654206,38.31775701,149100
624,93250,168,456,624,441,800,1865,9.008042895,24.45040214,33.45844504,23.6461126,42.89544236,203700
625,93252,949,1585,2534,1405,1685,5624,16.87411095,28.18278805,45.056899,24.98221906,29.96088193,151100
626,93254,23,35,58,29,48,135,17.03703704,25.92592593,42.96296296,21.48148148,35.55555556,182200
627,93256,45,136,181,151,257,589,7.640067912,23.08998302,30.73005093,25.63667233,43.63327674,162700
628,93257,1328,2796,4124,2928,3827,10879,12.20700432,25.70089163,37.90789595,26.91423844,35.17786561,211800
629,93261,6,49,55,82,217,354,1.694915254,13.84180791,15.53672316,23.16384181,61.29943503,127600
630,93263,247,611,858,737,1206,2801,8.818279186,21.81363799,30.63191717,26.31203142,43.05605141,206700
631,93265,34,55,89,68,55,212,16.03773585,25.94339623,41.98113208,32.0754717,25.94339623,305900
632,93267,106,186,292,193,393,878,12.07289294,21.18451025,33.25740319,21.98177677,44.76082005,143000
633,93268,140,359,499,456,755,1710,8.187134503,20.99415205,29.18128655,26.66666667,44.15204678,164200
634,93270,53,149,202,151,236,589,8.998302207,25.29711375,34.29541596,25.63667233,40.06791171,221700
635,93271,14,28,42,12,15,69,20.28985507,40.57971014,60.86956522,17.39130435,21.73913043,333600
636,93272,29,103,132,121,111,364,7.967032967,28.2967033,36.26373626,33.24175824,30.49450549,185200
637,93274,1137,2317,3454,2486,3491,9431,12.05598558,24.56791433,36.6238999,26.359877,37.01622309,246600
638,93277,816,1427,2243,1355,1818,5416,15.06646972,26.3478582,41.41432792,25.01846381,33.56720827,256600
639,93280,333,760,1093,835,1271,3199,10.40950297,23.7574242,34.16692716,26.10190685,39.73116599,188300
640,93283,27,47,74,51,60,185,14.59459459,25.40540541,40,27.56756757,32.43243243,119800
641,93286,85,220,305,277,502,1084,7.841328413,20.29520295,28.13653137,25.55350554,46.3099631,232800
642,93291,1277,1825,3102,1573,2127,6802,18.77389003,26.83034402,45.60423405,23.12555131,31.27021464,294800
643,93292,407,820,1227,925,1399,3551,11.46156012,23.09208674,34.55364686,26.04900028,39.39735286,252500
644,93301,300,529,829,479,847,2155,13.92111369,24.54756381,38.46867749,22.22737819,39.30394432,190600
645,93304,476,995,1471,1297,2492,5260,9.049429658,18.91634981,27.96577947,24.65779468,47.37642586,179300
646,93305,187,382,569,644,1796,3009,6.214689266,12.69524759,18.90993686,21.40245929,59.68760386,169300
647,93306,1025,2297,3322,2555,4165,10042,10.20713005,22.8739295,33.08105955,25.44313882,41.47580163,227700
648,93307,1077,2606,3683,2797,4812,11292,9.537725824,23.07828551,32.61601134,24.76974849,42.61424017,187100
649,93308,462,940,1402,1087,1922,4411,10.47381546,21.31036046,31.78417592,24.64293811,43.57288597,242800
650,93309,631,1415,2046,1586,2239,5871,10.74774314,24.10151593,34.84925907,27.01413728,38.13660365,226200
651,93311,1645,1890,3535,1280,1341,6156,26.72189734,30.70175439,57.42365172,20.79272255,21.78362573,324800
652,93312,1826,2668,4494,1853,1572,7919,23.05846698,33.69112262,56.74958959,23.39941912,19.85099129,328400
653,93313,962,1514,2476,1473,1583,5532,17.38973247,27.36804049,44.75777296,26.62689805,28.61532899,283400
654,93314,370,562,932,418,381,1731,21.37492779,32.46678221,53.84170999,24.14789139,22.01039861,412200
655,93401,418,284,702,182,158,1042,40.11516315,27.25527831,67.37044146,17.46641075,15.16314779,775100
656,93402,232,275,507,172,120,799,29.03629537,34.41802253,63.4543179,21.52690864,15.01877347,616100
657,93405,578,508,1086,336,367,1789,32.30855226,28.39575182,60.70430408,18.78144215,20.51425377,753500
658,93420,543,782,1325,555,500,2380,22.81512605,32.85714286,55.67226891,23.31932773,21.00840336,710000
659,93422,382,604,986,461,489,1936,19.73140496,31.19834711,50.92975207,23.81198347,25.25826446,573000
660,93426,2,10,12,12,7,31,6.451612903,32.25806452,38.70967742,38.70967742,22.58064516,446200
661,93427,60,116,176,93,107,376,15.95744681,30.85106383,46.80851064,24.73404255,28.45744681,621600
662,93428,33,59,92,60,97,249,13.25301205,23.69477912,36.94779116,24.09638554,38.95582329,705200
663,93430,37,41,78,20,14,112,33.03571429,36.60714286,69.64285714,17.85714286,12.5,896700
664,93432,3,5,8,5,14,27,11.11111111,18.51851852,29.62962963,18.51851852,51.85185185,657700
665,93433,90,167,257,189,204,650,13.84615385,25.69230769,39.53846154,29.07692308,31.38461538,577300
666,93434,58,164,222,225,413,860,6.744186047,19.06976744,25.81395349,26.1627907,48.02325581,337100
667,93436,399,799,1198,885,1407,3490,11.43266476,22.89398281,34.32664756,25.35816619,40.31518625,373600
668,93440,15,24,39,37,50,126,11.9047619,19.04761905,30.95238095,29.36507937,39.68253968,553800
669,93441,29,34,63,19,19,101,28.71287129,33.66336634,62.37623762,18.81188119,18.81188119,927500
670,93442,93,96,189,59,62,310,30,30.96774194,60.96774194,19.03225806,20,711900
671,93444,176,269,445,262,356,1063,16.55691439,25.30573848,41.86265287,24.64722484,33.4901223,643200
672,93445,21,59,80,57,71,208,10.09615385,28.36538462,38.46153846,27.40384615,34.13461538,425200
673,93446,545,893,1438,845,1206,3489,15.62052164,25.59472628,41.21524792,24.21897392,34.56577816,502500
674,93449,136,222,358,157,106,621,21.90016103,35.74879227,57.6489533,25.28180354,17.06924316,771400
675,93450,0,11,11,24,21,56,0,19.64285714,19.64285714,42.85714286,37.5,338100
676,93451,43,65,108,74,95,277,15.5234657,23.46570397,38.98916968,26.71480144,34.29602888,427400
677,93453,36,29,65,31,17,113,31.85840708,25.66371681,57.52212389,27.43362832,15.04424779,504200
678,93454,502,1193,1695,1555,2482,5732,8.757850663,20.81297976,29.57083043,27.12840195,43.30076762,375900
679,93455,735,1295,2030,1150,1341,4521,16.25746516,28.64410529,44.90157045,25.43685025,29.6615793,452600
680,93458,424,1161,1585,1473,2737,5795,7.316652286,20.03451251,27.3511648,25.41846419,47.23037101,361300
681,93460,108,142,250,72,46,368,29.34782609,38.58695652,67.93478261,19.56521739,12.5,962500
682,93461,5,14,19,48,78,145,3.448275862,9.655172414,13.10344828,33.10344828,53.79310345,346500
683,93463,113,144,257,73,75,405,27.90123457,35.55555556,63.45679012,18.02469136,18.51851852,892900
684,93465,260,368,628,256,201,1085,23.96313364,33.91705069,57.88018433,23.59447005,18.52534562,763200
685,93501,7,48,55,83,280,418,1.674641148,11.48325359,13.15789474,19.85645933,66.98564593,120300
686,93505,72,180,252,253,678,1183,6.086221471,15.21555368,21.30177515,21.386306,57.31191885,169100
687,93510,468,691,1159,631,763,2553,18.33137485,27.06619663,45.39757148,24.71602037,29.88640815,589000
688,93513,8,25,33,32,31,96,8.333333333,26.04166667,34.375,33.33333333,32.29166667,269600
689,93514,131,243,374,273,306,953,13.74606506,25.49842602,39.24449108,28.64637985,32.10912907,337700
690,93516,11,35,46,59,134,239,4.60251046,14.64435146,19.24686192,24.68619247,56.06694561,74500
691,93517,10,6,16,10,1,27,37.03703704,22.22222222,59.25925926,37.03703704,3.703703704,254200
692,93518,3,12,15,8,15,38,7.894736842,31.57894737,39.47368421,21.05263158,39.47368421,235800
693,93523,97,162,259,163,166,588,16.49659864,27.55102041,44.04761905,27.72108844,28.23129252,81200
694,93526,4,6,10,11,10,31,12.90322581,19.35483871,32.25806452,35.48387097,32.25806452,223500
695,93527,14,7,21,23,28,72,19.44444444,9.722222222,29.16666667,31.94444444,38.88888889,212100
696,93532,17,31,48,29,18,95,17.89473684,32.63157895,50.52631579,30.52631579,18.94736842,318700
697,93534,154,417,571,699,1580,2850,5.403508772,14.63157895,20.03508772,24.52631579,55.43859649,257600
698,93535,515,1528,2043,2268,4631,8942,5.759337956,17.0878998,22.84723775,25.36345337,51.78930888,241800
699,93536,863,1865,2728,1937,2527,7192,11.99944383,25.93159066,37.93103448,26.932703,35.13626251,377300
700,93541,13,20,33,13,10,56,23.21428571,35.71428571,58.92857143,23.21428571,17.85714286,216300
701,93543,81,214,295,273,483,1051,7.706945766,20.36156042,28.06850618,25.97526166,45.95623216,266000
702,93545,22,51,73,36,42,151,14.56953642,33.77483444,48.34437086,23.8410596,27.81456954,197600
703,93546,82,164,246,126,167,539,15.21335807,30.42671614,45.64007421,23.37662338,30.98330241,493800
704,93550,487,1630,2117,2129,3809,8055,6.045934202,20.23587834,26.28181254,26.43078833,47.28739913,280900
705,93551,957,1691,2648,1601,2080,6329,15.12087218,26.71828093,41.8391531,25.29625533,32.86459156,410900
706,93552,349,872,1221,1052,1548,3821,9.133734624,22.82125098,31.95498561,27.53205967,40.51295472,324500
707,93553,24,51,75,76,101,252,9.523809524,20.23809524,29.76190476,30.15873016,40.07936508,288800
708,93555,358,677,1035,589,912,2536,14.11671924,26.6955836,40.81230284,23.22555205,35.96214511,194600
709,93560,143,327,470,482,911,1863,7.675791734,17.55233494,25.22812668,25.87224906,48.89962426,240800
710,93561,231,509,740,539,748,2027,11.39615195,25.11100148,36.50715343,26.59102121,36.90182536,295000
711,93562,5,20,25,24,47,96,5.208333333,20.83333333,26.04166667,25,48.95833333,57600
712,93591,55,171,226,251,510,987,5.572441743,17.32522796,22.89766971,25.43059777,51.67173252,207200
713,93601,26,37,63,60,57,180,14.44444444,20.55555556,35,33.33333333,31.66666667,327800
714,93602,14,21,35,14,5,54,25.92592593,38.88888889,64.81481481,25.92592593,9.259259259,291300
715,93605,5,7,12,2,7,21,23.80952381,33.33333333,57.14285714,9.523809524,33.33333333,297700
716,93608,2,19,21,38,56,115,1.739130435,16.52173913,18.26086957,33.04347826,48.69565217,154600
717,93609,94,248,342,229,309,880,10.68181818,28.18181818,38.86363636,26.02272727,35.11363636,206000
718,93610,144,453,597,561,766,1924,7.484407484,23.54469854,31.02910603,29.15800416,39.81288981,250600
719,93611,3107,3136,6243,1807,1304,9354,33.21573658,33.52576438,66.74150096,19.31793885,13.94056019,365400
720,93612,539,930,1469,640,586,2695,20,34.50834879,54.50834879,23.74768089,21.74397032,243900
721,93614,34,85,119,101,152,372,9.139784946,22.84946237,31.98924731,27.15053763,40.86021505,307300
722,93615,40,67,107,74,139,320,12.5,20.9375,33.4375,23.125,43.4375,171900
723,93616,14,36,50,39,46,135,10.37037037,26.66666667,37.03703704,28.88888889,34.07407407,198000
724,93618,555,1134,1689,963,1147,3799,14.60910766,29.84996052,44.45906818,25.34877599,30.19215583,237000
725,93619,761,522,1283,281,181,1745,43.61031519,29.91404011,73.5243553,16.10315186,10.37249284,452500
726,93620,84,213,297,302,526,1125,7.466666667,18.93333333,26.4,26.84444444,46.75555556,267700
727,93622,116,282,398,294,432,1124,10.3202847,25.08896797,35.40925267,26.15658363,38.4341637,185900
728,93625,194,330,524,336,390,1250,15.52,26.4,41.92,26.88,31.2,298100
729,93630,307,811,1118,747,854,2719,11.29091578,29.82714233,41.11805811,27.47333579,31.40860611,262200
730,93631,432,667,1099,531,533,2163,19.97226075,30.83680074,50.80906149,24.54923717,24.64170134,326800
731,93635,560,1354,1914,1558,2363,5835,9.597257926,23.20479863,32.80205656,26.70094259,40.49700086,343000
732,93636,313,454,767,305,288,1360,23.01470588,33.38235294,56.39705882,22.42647059,21.17647059,375000
733,93637,403,1140,1543,1364,1950,4857,8.297302862,23.47127857,31.76858143,28.08317892,40.14823965,275900
734,93638,474,1367,1841,1692,2790,6323,7.496441563,21.61948442,29.11592598,26.75944963,44.12462439,239700
735,93640,261,462,723,450,751,1924,13.56548857,24.01247401,37.57796258,23.38877339,39.03326403,204600
736,93643,10,25,35,34,65,134,7.462686567,18.65671642,26.11940299,25.37313433,48.50746269,237800
737,93644,97,183,280,174,242,696,13.93678161,26.29310345,40.22988506,25,34.77011494,301300
738,93646,193,345,538,328,448,1314,14.68797565,26.25570776,40.94368341,24.96194825,34.09436834,201700
739,93647,247,466,713,416,650,1779,13.88420461,26.19449129,40.0786959,23.38392355,36.53738055,167400
740,93648,190,379,569,532,996,2097,9.060562709,18.07343825,27.13400095,25.36957558,47.49642346,186100
741,93650,70,142,212,141,177,530,13.20754717,26.79245283,40,26.60377358,33.39622642,192600
742,93651,51,84,135,83,99,317,16.08832808,26.49842271,42.58675079,26.1829653,31.23028391,366400
743,93652,5,26,31,55,105,191,2.617801047,13.61256545,16.23036649,28.79581152,54.97382199,169900
744,93653,3,15,18,13,16,47,6.382978723,31.91489362,38.29787234,27.65957447,34.04255319,443500
745,93654,626,889,1515,774,751,3040,20.59210526,29.24342105,49.83552632,25.46052632,24.70394737,250200
746,93656,86,237,323,219,291,833,10.32412965,28.45138055,38.7755102,26.29051621,34.93397359,208200
747,93657,836,1469,2305,1309,1526,5140,16.26459144,28.57976654,44.84435798,25.46692607,29.68871595,307100
748,93660,13,34,47,85,214,346,3.757225434,9.826589595,13.58381503,24.56647399,61.84971098,207900
749,93662,394,862,1256,859,961,3076,12.80884265,28.02340702,40.83224967,27.92587776,31.24187256,216900
750,93667,43,94,137,59,75,271,15.86715867,34.68634686,50.55350554,21.77121771,27.67527675,283300
751,93668,10,21,31,43,119,193,5.18134715,10.88082902,16.06217617,22.27979275,61.65803109,370600
752,93673,18,37,55,42,43,140,12.85714286,26.42857143,39.28571429,30,30.71428571,176100
753,93701,260,585,845,801,1717,3363,7.731192388,17.39518287,25.12637526,23.81801963,51.05560511,164100
754,93702,363,876,1239,946,1859,4044,8.976261128,21.66172107,30.6379822,23.39268051,45.96933729,159800
755,93703,224,597,821,623,1318,2762,8.11006517,21.6147719,29.72483707,22.55611875,47.71904417,183200
756,93704,528,1161,1689,1216,1829,4734,11.15335868,24.52471483,35.67807351,25.68652302,38.63540346,291600
757,93705,200,465,665,638,1263,2566,7.794232268,18.12159002,25.91582229,24.86360094,49.22057677,213400
758,93706,798,1563,2361,1477,2841,6679,11.94789639,23.40170684,35.34960323,22.11408894,42.53630783,186300
759,93710,199,459,658,511,715,1884,10.5626327,24.36305732,34.92569002,27.12314225,37.95116773,281800
760,93711,246,468,714,368,490,1572,15.64885496,29.77099237,45.41984733,23.40966921,31.17048346,398800
761,93720,1595,1387,2982,690,512,4184,38.12141491,33.1500956,71.27151052,16.49139579,12.23709369,370800
762,93721,28,54,82,67,209,358,7.82122905,15.08379888,22.90502793,18.7150838,58.37988827,181500
763,93722,939,1731,2670,1592,1940,6202,15.14027733,27.9103515,43.05062883,25.66913899,31.28023218,270900
764,93723,233,513,746,480,798,2024,11.51185771,25.3458498,36.85770751,23.71541502,39.42687747,374300
765,93725,309,623,932,711,1292,2935,10.52810903,21.22657581,31.75468484,24.22487223,44.02044293,226200
766,93726,754,1368,2122,1464,2149,5735,13.14734089,23.85353095,37.00087184,25.52746295,37.47166521,214600
767,93727,899,1566,2465,1630,2568,6663,13.49242083,23.50292661,36.99534744,24.4634549,38.54119766,287000
768,93728,70,136,206,261,640,1107,6.323396567,12.28545619,18.60885276,23.57723577,57.81391147,210500
769,93730,1095,654,1749,211,98,2058,53.20699708,31.77842566,84.98542274,10.2526725,4.761904762,522200
770,93737,82,121,203,80,85,368,22.2826087,32.88043478,55.16304348,21.73913043,23.09782609,387300
771,93901,413,818,1231,811,1151,3193,12.93454432,25.61854056,38.55308487,25.39931099,36.04760413,569700
772,93905,676,1719,2395,1879,3221,7495,9.019346231,22.93529019,31.95463642,25.0700467,42.97531688,444400
773,93906,640,1659,2299,1844,2881,7024,9.111617312,23.6190205,32.73063781,26.25284738,41.01651481,466900
774,93907,124,282,406,373,865,1644,7.542579075,17.15328467,24.69586375,22.68856448,52.61557178,566800
775,93908,221,321,542,192,105,839,26.340882,38.25983313,64.60071514,22.88438617,12.51489869,846200
776,93920,4,4,8,9,4,21,19.04761905,19.04761905,38.0952381,42.85714286,19.04761905,1081500
777,93923,198,145,343,52,25,420,47.14285714,34.52380952,81.66666667,12.38095238,5.952380952,1199000
778,93924,100,67,167,34,14,215,46.51162791,31.1627907,77.6744186,15.81395349,6.511627907,987100
779,93925,24,39,63,49,65,177,13.55932203,22.03389831,35.59322034,27.68361582,36.72316384,531300
780,93926,87,243,330,290,457,1077,8.077994429,22.56267409,30.64066852,26.9266481,42.43268338,453700
781,93927,205,474,679,616,1198,2493,8.223024469,19.01323706,27.23626153,24.70918572,48.05455275,350400
782,93930,172,428,600,502,924,2026,8.489634748,21.12537019,29.61500494,24.77788746,45.6071076,336200
783,93932,7,20,27,20,43,90,7.777777778,22.22222222,30,22.22222222,47.77777778,388100
784,93933,135,285,420,331,555,1306,10.33690658,21.82235835,32.15926493,25.34456355,42.49617152,599700
785,93940,344,457,801,343,361,1505,22.85714286,30.3654485,53.22259136,22.79069767,23.98671096,861000
786,93950,436,410,846,213,138,1197,36.42439432,34.25229741,70.67669173,17.79448622,11.52882206,929200
787,93954,2,7,9,16,25,50,4,14,18,32,50,230800
788,93955,269,522,791,662,917,2370,11.35021097,22.02531646,33.37552743,27.93248945,38.69198312,588100
789,93960,219,565,784,655,1111,2550,8.588235294,22.15686275,30.74509804,25.68627451,43.56862745,432200
790,93962,59,85,144,79,83,306,19.28104575,27.77777778,47.05882353,25.81699346,27.12418301,562500
791,94002,1401,728,2129,273,162,2564,54.64118565,28.39313573,83.03432137,10.6474259,6.31825273,1678500
792,94005,89,58,147,44,28,219,40.63926941,26.48401826,67.12328767,20.0913242,12.78538813,923800
793,94010,1622,969,2591,405,331,3327,48.75263,29.12533814,77.87796814,12.17312894,9.948902916,2000000
794,94014,280,511,791,488,590,1869,14.98127341,27.34082397,42.32209738,26.11021937,31.56768325,865400
795,94015,647,834,1481,611,708,2800,23.10714286,29.78571429,52.89285714,21.82142857,25.28571429,932200
796,94019,202,302,504,289,419,1212,16.66666667,24.91749175,41.58415842,23.84488449,34.5709571,1273400
797,94020,10,8,18,5,3,26,38.46153846,30.76923077,69.23076923,19.23076923,11.53846154,838200
798,94022,1346,560,1906,200,115,2221,60.60333183,25.21386763,85.81719946,9.004952724,5.177847816,2000000
799,94024,799,305,1104,101,47,1252,63.81789137,24.36102236,88.17891374,8.067092652,3.75399361,2000000
800,94025,1186,795,1981,554,717,3252,36.4698647,24.44649446,60.91635916,17.03567036,22.04797048,2000000
801,94027,484,216,700,131,163,994,48.69215292,21.73038229,70.42253521,13.17907445,16.39839034,2000000
802,94028,161,98,259,38,13,310,51.93548387,31.61290323,83.5483871,12.25806452,4.193548387,2000000
803,94030,550,424,974,247,189,1410,39.0070922,30.07092199,69.07801418,17.5177305,13.40425532,1606700
804,94037,32,27,59,23,11,93,34.40860215,29.03225806,63.44086022,24.7311828,11.82795699,1244300
805,94040,999,514,1513,286,342,2141,46.66043905,24.00747314,70.66791219,13.35824381,15.973844,2000000
806,94041,90,41,131,25,34,190,47.36842105,21.57894737,68.94736842,13.15789474,17.89473684,1804400
807,94043,441,335,776,191,172,1139,38.71817384,29.41176471,68.12993854,16.7690957,15.10096576,1341300
808,94044,476,633,1109,451,427,1987,23.95571213,31.85707096,55.81278309,22.69753397,21.48968294,1012200
809,94060,16,36,52,35,29,116,13.79310345,31.03448276,44.82758621,30.17241379,25,1012800
810,94061,246,295,541,244,421,1206,20.39800995,24.46102819,44.85903814,20.23217247,34.90878939,1558300
811,94062,806,636,1442,321,371,2134,37.76944705,29.8031865,67.57263355,15.04217432,17.38519213,2000000
812,94063,170,351,521,415,734,1670,10.17964072,21.01796407,31.19760479,24.8502994,43.95209581,1002400
813,94065,320,173,493,87,75,655,48.85496183,26.41221374,75.26717557,13.28244275,11.45038168,1545800
814,94066,467,497,964,394,576,1934,24.14684592,25.69803516,49.84488108,20.37228542,29.78283351,1027400
815,94070,1008,577,1585,222,125,1932,52.17391304,29.86542443,82.03933747,11.49068323,6.469979296,1910300
816,94080,607,1003,1610,795,902,3307,18.35500454,30.32960387,48.68460841,24.03991533,27.27547626,963700
817,94085,115,226,341,230,347,918,12.52723312,24.61873638,37.1459695,25.05446623,37.79956427,1217000
818,94086,280,190,470,156,212,838,33.41288783,22.67303103,56.08591885,18.61575179,25.29832936,1504000
819,94087,1947,1390,3337,732,628,4697,41.45199063,29.59335746,71.04534809,15.58441558,13.37023632,1945100
820,94089,208,236,444,140,150,734,28.33787466,32.15258856,60.49046322,19.07356948,20.4359673,338100
821,94102,11,18,29,35,86,150,7.333333333,12,19.33333333,23.33333333,57.33333333,968000
822,94103,27,76,103,102,270,475,5.684210526,16,21.68421053,21.47368421,56.84210526,960000
823,94107,102,88,190,72,167,429,23.77622378,20.51282051,44.28904429,16.78321678,38.92773893,1134600
824,94108,118,95,213,68,72,353,33.42776204,26.9121813,60.33994334,19.26345609,20.39660057,1129100
825,94109,190,179,369,124,178,671,28.31594635,26.67660209,54.99254844,18.47988077,26.52757079,1171200
826,94110,177,351,528,462,894,1884,9.394904459,18.63057325,28.02547771,24.52229299,47.4522293,1233600
827,94112,401,571,972,556,834,2362,16.97713802,24.17442845,41.15156647,23.53937341,35.30906012,1022100
828,94114,298,376,674,442,895,2011,14.81849826,18.69716559,33.51566385,21.97911487,44.50522128,1593400
829,94115,317,391,708,316,315,1339,23.67438387,29.20089619,52.87528006,23.59970127,23.52501867,1515600
830,94116,722,724,1446,404,395,2245,32.16035635,32.24944321,64.40979955,17.99554566,17.59465479,1188000
831,94117,242,148,390,91,75,556,43.52517986,26.61870504,70.14388489,16.36690647,13.48920863,1478600
832,94118,359,330,689,177,109,975,36.82051282,33.84615385,70.66666667,18.15384615,11.17948718,1609400
833,94121,729,721,1450,359,244,2053,35.5090112,35.11933755,70.62834876,17.48660497,11.88504627,1506400
834,94122,1001,833,1834,424,305,2563,39.05579399,32.50097542,71.55676941,16.54311354,11.90011705,1239600
835,94123,361,399,760,211,199,1170,30.85470085,34.1025641,64.95726496,18.03418803,17.00854701,2000000
836,94124,42,107,149,156,411,716,5.865921788,14.94413408,20.81005587,21.7877095,57.40223464,873900
837,94127,398,435,833,262,226,1321,30.12869039,32.92959879,63.05828917,19.8334595,17.10825132,1572100
838,94131,384,292,676,175,266,1117,34.37779767,26.14145031,60.51924799,15.66696509,23.81378693,1458500
839,94132,592,188,780,100,94,974,60.78028747,19.30184805,80.08213552,10.26694045,9.650924025,1171000
840,94133,323,316,639,238,307,1184,27.28040541,26.68918919,53.96959459,20.10135135,25.92905405,1393700
841,94134,215,347,562,335,584,1481,14.5172181,23.43011479,37.94733288,22.61985145,39.43281567,925900
842,94301,336,140,476,56,52,584,57.53424658,23.97260274,81.50684932,9.589041096,8.904109589,2000000
843,94303,747,556,1303,470,832,2605,28.6756238,21.34357006,50.01919386,18.04222649,31.93857965,1567000
844,94305,246,90,336,49,28,413,59.56416465,21.79176755,81.3559322,11.86440678,6.779661017,2000000
845,94306,1537,720,2257,246,156,2659,57.8036856,27.07784882,84.88153441,9.251598345,5.866867243,2000000
846,94401,390,181,571,116,199,886,44.01805869,20.42889391,64.4469526,13.09255079,22.46049661,944300
847,94402,732,627,1359,379,609,2347,31.1887516,26.71495526,57.90370686,16.14827439,25.94801875,1882300
848,94403,658,649,1307,517,844,2668,24.66266867,24.32533733,48.988006,19.37781109,31.63418291,1499300
849,94404,867,553,1420,240,159,1819,47.6635514,30.40131941,78.06487081,13.19406267,8.74106652,1404600
850,94501,1462,1507,2969,846,807,4622,31.63132843,32.60493293,64.23626136,18.3037646,17.45997404,969500
851,94502,293,182,475,99,57,631,46.43423138,28.84310618,75.27733756,15.68938193,9.033280507,978600
852,94503,354,527,881,373,423,1677,21.10912343,31.42516398,52.53428742,22.24209899,25.2236136,557800
853,94505,82,116,198,87,125,410,20,28.29268293,48.29268293,21.2195122,30.48780488,674800
854,94506,784,522,1306,190,104,1600,49,32.625,81.625,11.875,6.5,1380000
855,94507,329,354,683,185,67,935,35.18716578,37.86096257,73.04812834,19.78609626,7.165775401,1799100
856,94508,10,11,21,22,19,62,16.12903226,17.74193548,33.87096774,35.48387097,30.64516129,684400
857,94509,276,802,1078,1114,2240,4432,6.227436823,18.09566787,24.32310469,25.13537906,50.54151625,435600
858,94510,429,672,1101,525,538,2164,19.82439926,31.05360444,50.8780037,24.26062847,24.86136784,628300
859,94513,1720,2444,4164,1726,1596,7486,22.97622228,32.64760887,55.62383115,23.05637189,21.31979695,635600
860,94514,52,128,180,134,134,448,11.60714286,28.57142857,40.17857143,29.91071429,29.91071429,711000
861,94515,49,129,178,146,106,430,11.39534884,30,41.39534884,33.95348837,24.65116279,731200
862,94516,14,18,32,10,7,49,28.57142857,36.73469388,65.30612245,20.40816327,14.28571429,685500
863,94517,254,291,545,171,129,845,30.0591716,34.43786982,64.49704142,20.23668639,15.26627219,815600
864,94518,110,237,347,353,701,1401,7.851534618,16.91648822,24.76802284,25.19628837,50.03568879,649100
865,94519,135,142,277,161,260,698,19.34097421,20.34383954,39.68481375,23.06590258,37.24928367,608400
866,94520,108,255,363,334,689,1386,7.792207792,18.3982684,26.19047619,24.0981241,49.71139971,480300
867,94521,521,772,1293,710,832,2835,18.37742504,27.23104056,45.60846561,25.04409171,29.34744268,649100
868,94523,879,1040,1919,758,755,3432,25.61188811,30.3030303,55.91491841,22.08624709,21.9988345,827200
869,94525,22,80,102,93,146,341,6.451612903,23.46041056,29.91202346,27.27272727,42.81524927,591000
870,94526,1386,1214,2600,530,208,3338,41.52186938,36.36908328,77.89095267,15.87777112,6.231276213,1265000
871,94530,456,528,984,422,674,2080,21.92307692,25.38461538,47.30769231,20.28846154,32.40384615,891700
872,94531,282,671,953,860,1435,3248,8.68226601,20.658867,29.341133,26.47783251,44.18103448,528200
873,94533,787,1692,2479,1671,2684,6834,11.51594966,24.75856014,36.2745098,24.45127305,39.27421715,393700
874,94534,998,1193,2191,878,756,3825,26.09150327,31.18954248,57.28104575,22.95424837,19.76470588,589000
875,94536,3044,1733,4777,862,763,6402,47.54764136,27.06966573,74.61730709,13.46454233,11.91815058,989600
876,94538,2491,1504,3995,859,888,5742,43.38209683,26.19296412,69.57506095,14.95994427,15.46499478,888400
877,94539,2744,824,3568,267,178,4013,68.37777224,20.53326688,88.91103912,6.653376526,4.435584351,1548800
878,94541,368,771,1139,822,1479,3440,10.69767442,22.4127907,33.11046512,23.89534884,42.99418605,641200
879,94542,68,100,168,60,114,342,19.88304094,29.23976608,49.12280702,17.54385965,33.33333333,884200
880,94544,181,414,595,524,1116,2235,8.098434004,18.52348993,26.62192394,23.44519016,49.93288591,624800
881,94545,499,939,1438,860,892,3190,15.64263323,29.43573668,45.07836991,26.95924765,27.96238245,664400
882,94546,1085,891,1976,556,477,3009,36.05849119,29.6111665,65.66965769,18.47789963,15.85244267,811300
883,94547,287,406,693,294,339,1326,21.64404223,30.61840121,52.26244344,22.1719457,25.56561086,590800
884,94548,24,56,80,55,62,197,12.18274112,28.42639594,40.60913706,27.91878173,31.47208122,817500
885,94549,1297,730,2027,267,109,2403,53.97419892,30.3786933,84.35289222,11.11111111,4.535996671,1547800
886,94550,1310,1210,2520,777,694,3991,32.82385367,30.31821599,63.14206966,19.46880481,17.38912553,925400
887,94551,618,672,1290,493,544,2327,26.55779974,28.87838419,55.43618393,21.18607649,23.37773958,774200
888,94552,551,617,1168,330,219,1717,32.09085614,35.93476995,68.02562609,19.21956902,12.75480489,1056100
889,94553,543,633,1176,497,533,2206,24.61468722,28.69446963,53.30915684,22.5294651,24.16137806,628400
890,94555,894,323,1217,127,92,1436,62.25626741,22.49303621,84.74930362,8.844011142,6.406685237,1078400
891,94556,747,511,1258,182,68,1508,49.53580902,33.88594164,83.42175066,12.06896552,4.50928382,1224100
892,94558,788,1469,2257,1414,1966,5637,13.97906688,26.05996097,40.03902785,25.08426468,34.87670747,693700
893,94559,68,142,210,170,297,677,10.04431315,20.97488922,31.01920236,25.11078287,43.87001477,704900
894,94560,522,643,1165,520,742,2427,21.50803461,26.49361351,48.00164813,21.42562835,30.57272353,870200
895,94561,578,1112,1690,1044,1479,4213,13.71943983,26.39449324,40.11393306,24.78044149,35.10562545,501200
896,94563,1048,558,1606,194,60,1860,56.34408602,30,86.34408602,10.43010753,3.225806452,1539900
897,94564,203,389,592,395,537,1524,13.32020997,25.52493438,38.84514436,25.91863517,35.23622047,590900
898,94565,654,1499,2153,1687,3112,6952,9.407364787,21.56214039,30.96950518,24.26639816,44.76409666,442300
899,94566,1894,1339,3233,582,427,4242,44.64875059,31.56529939,76.21404998,13.71994342,10.0660066,1195200
900,94567,1,3,4,6,24,34,2.941176471,8.823529412,11.76470588,17.64705882,70.58823529,383300
901,94568,3417,1950,5367,752,507,6626,51.5695744,29.42952007,80.99909448,11.3492303,7.651675219,983000
902,94571,64,125,189,114,137,440,14.54545455,28.40909091,42.95454545,25.90909091,31.13636364,398900
903,94572,27,46,73,76,116,265,10.18867925,17.35849057,27.54716981,28.67924528,43.77358491,546400
904,94574,163,191,354,141,87,582,28.00687285,32.81786942,60.82474227,24.22680412,14.94845361,1295900
905,94577,454,807,1261,881,1214,3356,13.52800954,24.04648391,37.57449344,26.25148987,36.17401669,667600
906,94578,52,105,157,143,307,607,8.566721582,17.29818781,25.86490939,23.55848435,50.57660626,633500
907,94579,165,297,462,315,417,1194,13.81909548,24.87437186,38.69346734,26.38190955,34.92462312,659600
908,94580,462,832,1294,826,1013,3133,14.7462496,26.5560166,41.3022662,26.36450686,32.33322694,649600
909,94582,2814,1623,4437,524,355,5316,52.93453725,30.53047404,83.46501129,9.857035365,6.677953348,1153600
910,94583,1759,1450,3209,601,344,4154,42.34472797,34.90611459,77.25084256,14.46798267,8.281174771,987300
911,94585,155,345,500,388,677,1565,9.904153355,22.04472843,31.94888179,24.79233227,43.25878594,419200
912,94586,77,55,132,34,13,179,43.01675978,30.72625698,73.74301676,18.99441341,7.262569832,1166700
913,94587,1232,1465,2697,1109,1208,5014,24.57120064,29.21818907,53.78938971,22.11806941,24.09254089,860300
914,94588,1575,838,2413,327,190,2930,53.75426621,28.60068259,82.35494881,11.16040956,6.484641638,1050600
915,94589,346,776,1122,723,1284,3129,11.05784596,24.80025567,35.85810163,23.10642378,41.03547459,372000
916,94590,130,251,381,335,766,1482,8.771929825,16.9365722,25.70850202,22.60458839,51.68690958,381400
917,94591,283,560,843,618,1106,2567,11.02454227,21.81534866,32.83989092,24.07479548,43.0853136,482700
918,94592,13,39,52,65,153,270,4.814814815,14.44444444,19.25925926,24.07407407,56.66666667,653700
919,94595,201,157,358,64,45,467,43.04068522,33.61884368,76.65952891,13.70449679,9.635974304,673500
920,94596,290,192,482,117,109,708,40.96045198,27.11864407,68.07909605,16.52542373,15.39548023,1081800
921,94597,396,445,841,220,144,1205,32.86307054,36.92946058,69.79253112,18.25726141,11.95020747,806800
922,94598,894,818,1712,461,326,2499,35.77430972,32.73309324,68.50740296,18.44737895,13.04521809,1050800
923,94601,252,646,898,850,1754,3502,7.195888064,18.44660194,25.64249001,24.27184466,50.08566533,581800
924,94602,187,180,367,180,354,901,20.75471698,19.97780244,40.73251942,19.97780244,39.28967814,919900
925,94603,131,410,541,640,1556,2737,4.786262331,14.97990501,19.76616734,23.38326635,56.85056631,447000
926,94605,164,399,563,524,1160,2247,7.298620383,17.75700935,25.05562973,23.3199822,51.62438807,695000
927,94606,261,429,690,456,677,1823,14.31705979,23.53263851,37.8496983,25.01371366,37.13658804,643100
928,94607,362,475,837,390,616,1843,19.64188823,25.77319588,45.4150841,21.1611503,33.4237656,640800
929,94608,297,331,628,311,494,1433,20.72575017,23.09839498,43.82414515,21.70272156,34.47313329,691300
930,94609,123,74,197,78,145,420,29.28571429,17.61904762,46.9047619,18.57142857,34.52380952,937000
931,94610,405,436,841,347,451,1639,24.71018914,26.60158633,51.31177547,21.171446,27.51677852,1125700
932,94611,1106,774,1880,430,405,2715,40.73664825,28.50828729,69.24493554,15.83793738,14.91712707,1199600
933,94612,158,214,372,200,279,851,18.56639248,25.14688602,43.7132785,23.50176263,32.78495887,848500
934,94618,355,299,654,139,114,907,39.14002205,32.96582139,72.10584344,15.32524807,12.56890849,1440300
935,94619,299,307,606,278,489,1373,21.77713037,22.35979607,44.13692644,20.24763292,35.61544064,790500
936,94621,147,454,601,637,1493,2731,5.38264372,16.62394727,22.00659099,23.32478945,54.66861955,445600
937,94702,161,68,229,42,33,304,52.96052632,22.36842105,75.32894737,13.81578947,10.85526316,958700
938,94703,446,532,978,307,263,1548,28.81136951,34.36692506,63.17829457,19.83204134,16.98966408,1061200
939,94704,310,211,521,115,160,796,38.94472362,26.50753769,65.45226131,14.44723618,20.10050251,787300
940,94705,410,300,710,184,125,1019,40.23552502,29.44062807,69.67615309,18.05691855,12.26692836,1420900
941,94706,729,608,1337,261,145,1743,41.82444062,34.88238669,76.70682731,14.97418244,8.318990247,964500
942,94707,40,48,88,40,42,170,23.52941176,28.23529412,51.76470588,23.52941176,24.70588235,1301800
943,94708,170,113,283,55,36,374,45.45454545,30.21390374,75.6684492,14.70588235,9.625668449,1208400
944,94709,96,49,145,22,29,196,48.97959184,25,73.97959184,11.2244898,14.79591837,1001900
945,94710,91,56,147,34,7,188,48.40425532,29.78723404,78.19148936,18.08510638,3.723404255,898500
946,94801,71,191,262,262,851,1375,5.163636364,13.89090909,19.05454545,19.05454545,61.89090909,475100
947,94803,163,327,490,323,599,1412,11.54390935,23.15864023,34.70254958,22.87535411,42.42209632,614700
948,94804,256,586,842,722,1680,3244,7.891491985,18.06411837,25.95561036,22.25647349,51.78791615,526600
949,94805,60,134,194,145,384,723,8.298755187,18.53388658,26.83264177,20.05532503,53.1120332,613400
950,94806,350,839,1189,1080,2107,4376,7.998171846,19.17276051,27.17093236,24.68007313,48.14899452,479200
951,94901,436,573,1009,589,911,2509,17.37744121,22.83778398,40.21522519,23.47548824,36.30928657,1136000
952,94903,488,585,1073,333,443,1849,26.39264467,31.63872363,58.03136831,18.00973499,23.9588967,940800
953,94904,288,261,549,110,86,745,38.65771812,35.03355705,73.69127517,14.76510067,11.54362416,1635600
954,94920,319,262,581,87,50,718,44.42896936,36.4902507,80.91922006,12.11699164,6.963788301,2000000
955,94923,1,1,2,2,7,11,9.090909091,9.090909091,18.18181818,18.18181818,63.63636364,1077700
956,94924,22,17,39,7,8,54,40.74074074,31.48148148,72.22222222,12.96296296,14.81481481,1119300
957,94925,245,137,382,43,33,458,53.49344978,29.91266376,83.40611354,9.388646288,7.205240175,1372500
958,94928,444,732,1176,761,868,2805,15.82887701,26.09625668,41.92513369,27.13012478,30.94474153,546100
959,94930,320,293,613,154,80,847,37.78040142,34.59268005,72.37308146,18.18181818,9.445100354,927100
960,94931,22,92,114,76,107,297,7.407407407,30.97643098,38.38383838,25.58922559,36.02693603,663100
961,94939,372,311,683,121,88,892,41.70403587,34.86547085,76.56950673,13.56502242,9.865470852,1697200
962,94941,779,694,1473,274,132,1879,41.45822246,36.93453965,78.39276211,14.58222459,7.025013305,1582800
963,94945,232,221,453,128,157,738,31.43631436,29.94579946,61.38211382,17.34417344,21.27371274,909300
964,94946,5,6,11,5,5,21,23.80952381,28.57142857,52.38095238,23.80952381,23.80952381,1736600
965,94947,434,587,1021,358,362,1741,24.92820218,33.71625503,58.64445721,20.56289489,20.7926479,851100
966,94949,215,384,599,268,359,1226,17.53670473,31.32137031,48.85807504,21.85970636,29.2822186,829100
967,94951,51,77,128,68,45,241,21.16182573,31.95020747,53.1120332,28.21576763,18.67219917,955000
968,94952,666,881,1547,642,596,2785,23.91382406,31.63375224,55.5475763,23.05206463,21.40035907,866200
969,94954,651,826,1477,623,617,2717,23.96025028,30.40117777,54.36142805,22.92970188,22.70887008,661700
970,94956,29,27,56,17,31,104,27.88461538,25.96153846,53.84615385,16.34615385,29.80769231,1299500
971,94957,106,94,200,26,9,235,45.10638298,40,85.10638298,11.06382979,3.829787234,2000000
972,94960,338,169,507,107,69,683,49.4875549,24.74377745,74.23133236,15.66617862,10.10248902,1308500
973,94963,22,31,53,28,19,100,22,31,53,28,19,928600
974,94965,38,54,92,75,77,244,15.57377049,22.13114754,37.70491803,30.73770492,31.55737705,1173700
975,94971,13,38,51,46,45,142,9.154929577,26.76056338,35.91549296,32.3943662,31.69014085,845200
976,95002,53,52,105,44,30,179,29.60893855,29.05027933,58.65921788,24.58100559,16.75977654,659100
977,95003,392,469,861,357,374,1592,24.62311558,29.45979899,54.08291457,22.42462312,23.49246231,935600
978,95004,33,75,108,58,68,234,14.1025641,32.05128205,46.15384615,24.78632479,29.05982906,780500
979,95005,68,68,136,33,30,199,34.17085427,34.17085427,68.34170854,16.58291457,15.07537688,804800
980,95006,575,605,1180,334,298,1812,31.73289183,33.38852097,65.1214128,18.43267108,16.44591611,646300
981,95008,469,366,835,311,326,1472,31.86141304,24.86413043,56.72554348,21.12771739,22.14673913,1230900
982,95010,161,232,393,136,110,639,25.19561815,36.30672926,61.50234742,21.28325509,17.2143975,760500
983,95012,133,339,472,396,687,1555,8.553054662,21.80064309,30.35369775,25.46623794,44.18006431,486000
984,95014,3526,1687,5213,502,310,6025,58.52282158,28,86.52282158,8.331950207,5.145228216,2000000
985,95017,11,31,42,19,10,71,15.49295775,43.66197183,59.15492958,26.76056338,14.08450704,908100
986,95018,185,214,399,186,169,754,24.53580902,28.38196286,52.91777188,24.66843501,22.4137931,657200
987,95019,14,33,47,78,154,279,5.017921147,11.82795699,16.84587814,27.95698925,55.19713262,471700
988,95020,988,1418,2406,1325,1889,5620,17.58007117,25.23131673,42.8113879,23.57651246,33.61209964,815900
989,95023,809,1465,2274,1335,1807,5416,14.93722304,27.04948301,41.98670606,24.64918759,33.36410635,609800
990,95030,671,576,1247,204,140,1591,42.17473287,36.20364551,78.37837838,12.82212445,8.799497172,2000000
991,95032,811,585,1396,279,168,1843,44.00434075,31.74172545,75.7460662,15.13836137,9.115572436,1726700
992,95033,132,142,274,62,48,384,34.375,36.97916667,71.35416667,16.14583333,12.5,1160400
993,95035,2016,1332,3348,675,689,4712,42.78438031,28.26825127,71.05263158,14.32512733,14.62224109,995200
994,95037,783,1028,1811,741,853,3405,22.99559471,30.19089574,53.18649046,21.76211454,25.05139501,954600
995,95045,34,75,109,70,117,296,11.48648649,25.33783784,36.82432432,23.64864865,39.52702703,726500
996,95046,28,52,80,102,245,427,6.557377049,12.17798595,18.735363,23.88758782,57.37704918,1092500
997,95050,329,404,733,366,379,1478,22.25981055,27.33423545,49.59404601,24.7631935,25.64276049,1140200
998,95051,1251,869,2120,568,595,3283,38.10539141,26.46969235,64.57508376,17.30124886,18.12366738,1253100
999,95054,232,243,475,149,209,833,27.85114046,29.17166867,57.02280912,17.88715486,25.09003601,1195700
1000,95060,562,595,1157,344,326,1827,30.76081007,32.56704981,63.32785988,18.8286809,17.84345922,971100
1001,95062,366,578,944,474,493,1911,19.1522763,30.24594453,49.39822083,24.80376766,25.79801151,840100
1002,95065,124,98,222,84,95,401,30.92269327,24.43890274,55.36159601,20.94763092,23.69077307,931400
1003,95066,326,343,669,223,148,1040,31.34615385,32.98076923,64.32692308,21.44230769,14.23076923,920600
1004,95070,1334,671,2005,227,139,2371,56.26318009,28.30029523,84.56347533,9.574019401,5.862505272,2000000
1005,95073,167,218,385,144,127,656,25.45731707,33.23170732,58.68902439,21.95121951,19.3597561,842800
1006,95075,1,2,3,12,13,28,3.571428571,7.142857143,10.71428571,42.85714286,46.42857143,809000
1007,95076,444,1277,1721,1899,3923,7543,5.886252154,16.92960361,22.81585576,25.17565955,52.00848469,626100
1008,95110,159,311,470,322,556,1348,11.79525223,23.07121662,34.86646884,23.88724036,41.2462908,739600
1009,95111,630,1008,1638,937,1623,4198,15.00714626,24.01143402,39.01858028,22.32015245,38.66126727,661700
1010,95112,199,448,647,525,974,2146,9.27306617,20.87604846,30.14911463,24.46411929,45.38676608,823900
1011,95116,346,644,990,739,1593,3322,10.4154124,19.3859121,29.8013245,22.24563516,47.95304034,687900
1012,95117,199,206,405,175,214,794,25.06297229,25.94458438,51.00755668,22.04030227,26.95214106,1141000
1013,95118,975,982,1957,622,758,3337,29.21786035,29.42762961,58.64548996,18.63949655,22.71501349,1111900
1014,95119,335,377,712,242,295,1249,26.82145717,30.18414732,57.00560448,19.3755004,23.61889512,950700
1015,95120,1661,1076,2737,543,429,3709,44.78296037,29.01051496,73.79347533,14.64006471,11.56645996,1546400
1016,95121,700,669,1369,468,593,2430,28.80658436,27.5308642,56.33744856,19.25925926,24.40329218,838900
1017,95122,1006,1574,2580,1457,2214,6251,16.09342505,25.1799712,41.27339626,23.30827068,35.41833307,674500
1018,95123,1103,1153,2256,716,865,3837,28.74641647,30.04951785,58.79593432,18.66041178,22.5436539,889800
1019,95124,1848,1462,3310,624,504,4438,41.64037855,32.94276701,74.58314556,14.06038756,11.35646688,1259000
1020,95125,994,1076,2070,778,925,3773,26.34508349,28.51842036,54.86350384,20.62019613,24.51630003,1300600
1021,95126,294,454,748,397,658,1803,16.30615641,25.18025513,41.48641154,22.01885746,36.494731,1011900
1022,95127,352,650,1002,798,1360,3160,11.13924051,20.56962025,31.70886076,25.25316456,43.03797468,806400
1023,95128,233,449,682,454,547,1683,13.84432561,26.67855021,40.52287582,26.97563874,32.50148544,1054000
1024,95129,2148,832,2980,286,197,3463,62.02714409,24.02541149,86.05255559,8.258735201,5.688709212,1641700
1025,95130,788,467,1255,302,351,1908,41.29979036,24.47589099,65.77568134,15.82809224,18.39622642,1409500
1026,95131,227,266,493,202,306,1001,22.67732268,26.57342657,49.25074925,20.17982018,30.56943057,976300
1027,95132,1524,1212,2736,603,639,3978,38.3107089,30.46757164,68.77828054,15.15837104,16.06334842,1072200
1028,95133,298,393,691,371,476,1538,19.37581274,25.5526658,44.92847854,24.12223667,30.94928479,869200
1029,95134,31,61,92,57,46,195,15.8974359,31.28205128,47.17948718,29.23076923,23.58974359,379800
1030,95135,867,548,1415,184,118,1717,50.4950495,31.91613279,82.41118229,10.71636575,6.872451951,1158400
1031,95136,175,228,403,288,415,1106,15.82278481,20.61482821,36.43761302,26.039783,37.52260398,897500
1032,95138,290,167,457,87,68,612,47.38562092,27.2875817,74.67320261,14.21568627,11.11111111,1129600
1033,95139,136,228,364,223,239,826,16.46489104,27.60290557,44.06779661,26.99757869,28.9346247,904600
1034,95148,1399,1224,2623,783,891,4297,32.55759832,28.48498953,61.04258785,18.22201536,20.73539679,998600
1035,95202,208,364,572,447,751,1770,11.75141243,20.56497175,32.31638418,25.25423729,42.42937853,265400
1036,95203,87,218,305,245,453,1003,8.673978066,21.73479561,30.40877368,24.42671984,45.16450648,268100
1037,95204,188,466,654,692,1255,2601,7.227989235,17.91618608,25.14417532,26.60515186,48.25067282,286300
1038,95205,197,579,776,864,1760,3400,5.794117647,17.02941176,22.82352941,25.41176471,51.76470588,225400
1039,95206,539,1541,2080,2187,4315,8582,6.280587276,17.95618737,24.23677464,25.48357026,50.27965509,291800
1040,95207,705,1355,2060,1405,2042,5507,12.80188851,24.60504812,37.40693663,25.51298348,37.0800799,318500
1041,95209,680,981,1661,1036,1523,4220,16.11374408,23.2464455,39.36018957,24.54976303,36.09004739,367400
1042,95210,285,529,814,581,999,2394,11.9047619,22.09690894,34.00167084,24.26900585,41.72932331,259000
1043,95212,590,1119,1709,1067,1214,3990,14.78696742,28.04511278,42.8320802,26.74185464,30.42606516,401500
1044,95215,167,573,740,654,1166,2560,6.5234375,22.3828125,28.90625,25.546875,45.546875,303500
1045,95219,397,570,967,521,638,2126,18.67356538,26.81091251,45.48447789,24.50611477,30.00940734,436900
1046,95220,95,197,292,151,159,602,15.7807309,32.72425249,48.50498339,25.08305648,26.41196013,642500
1047,95222,25,90,115,77,104,296,8.445945946,30.40540541,38.85135135,26.01351351,35.13513514,399200
1048,95223,21,11,32,23,16,71,29.57746479,15.49295775,45.07042254,32.3943662,22.53521127,360600
1049,95224,32,64,96,37,35,168,19.04761905,38.0952381,57.14285714,22.02380952,20.83333333,327800
1050,95228,9,35,44,40,50,134,6.71641791,26.11940299,32.8358209,29.85074627,37.31343284,350500
1051,95230,6,3,9,13,33,55,10.90909091,5.454545455,16.36363636,23.63636364,60,591900
1052,95231,22,68,90,106,180,376,5.85106383,18.08510638,23.93617021,28.19148936,47.87234043,341300
1053,95236,47,94,141,84,108,333,14.11411411,28.22822823,42.34234234,25.22522523,32.43243243,501400
1054,95237,37,78,115,77,142,334,11.07784431,23.35329341,34.43113772,23.05389222,42.51497006,372700
1055,95240,327,642,969,725,1292,2986,10.95110516,21.5003349,32.45144005,24.27997321,43.26858674,352400
1056,95242,681,1225,1906,1100,1340,4346,15.66958122,28.18683847,43.8564197,25.31063046,30.83294984,440100
1057,95245,10,17,27,24,36,87,11.49425287,19.54022989,31.03448276,27.5862069,41.37931034,383800
1058,95247,21,38,59,24,25,108,19.44444444,35.18518519,54.62962963,22.22222222,23.14814815,357500
1059,95249,54,131,185,147,213,545,9.908256881,24.03669725,33.94495413,26.97247706,39.08256881,332300
1060,95252,48,163,211,222,465,898,5.345211581,18.15144766,23.49665924,24.72160356,51.78173719,360200
1061,95255,2,15,17,23,15,55,3.636363636,27.27272727,30.90909091,41.81818182,27.27272727,231500
1062,95301,599,1174,1773,1011,1306,4090,14.64547677,28.70415648,43.34963325,24.71882641,31.93154034,288800
1063,95303,30,72,102,62,66,230,13.04347826,31.30434783,44.34782609,26.95652174,28.69565217,592600
1064,95304,375,599,974,507,666,2147,17.46623195,27.8993945,45.36562646,23.6143456,31.02002795,692400
1065,95306,15,22,37,23,13,73,20.54794521,30.1369863,50.68493151,31.50684932,17.80821918,283300
1066,95307,644,1534,2178,1712,2525,6415,10.03897116,23.9127046,33.95167576,26.68745129,39.36087295,313000
1067,95310,35,63,98,89,76,263,13.30798479,23.95437262,37.26235741,33.84030418,28.8973384,379500
1068,95311,1,3,4,13,18,35,2.857142857,8.571428571,11.42857143,37.14285714,51.42857143,252400
1069,95313,39,63,102,71,88,261,14.94252874,24.13793103,39.08045977,27.20306513,33.7164751,494000
1070,95315,122,316,438,306,529,1273,9.583660644,24.82325216,34.4069128,24.03770621,41.55538099,273000
1071,95316,68,192,260,209,267,736,9.239130435,26.08695652,35.32608696,28.39673913,36.27717391,375000
1072,95317,11,19,30,38,27,95,11.57894737,20,31.57894737,40,28.42105263,425000
1073,95318,11,10,21,5,10,36,30.55555556,27.77777778,58.33333333,13.88888889,27.77777778,241500
1074,95319,13,32,45,62,143,250,5.2,12.8,18,24.8,57.2,194700
1075,95320,190,402,592,344,349,1285,14.78599222,31.28404669,46.07003891,26.77042802,27.15953307,448000
1076,95321,11,26,37,34,66,137,8.02919708,18.97810219,27.00729927,24.81751825,48.17518248,330900
1077,95322,80,194,274,219,461,954,8.385744235,20.33542977,28.721174,22.95597484,48.32285115,354500
1078,95323,124,194,318,143,117,578,21.4532872,33.56401384,55.01730104,24.74048443,20.24221453,451400
1079,95324,130,299,429,292,399,1120,11.60714286,26.69642857,38.30357143,26.07142857,35.625,313200
1080,95326,156,338,494,328,381,1203,12.96758105,28.0964256,41.06400665,27.26517041,31.67082294,366500
1081,95327,21,29,50,49,99,198,10.60606061,14.64646465,25.25252525,24.74747475,50,271800
1082,95328,74,131,205,108,114,427,17.33021077,30.67915691,48.00936768,25.29274005,26.69789227,306000
1083,95329,17,32,49,37,51,137,12.40875912,23.35766423,35.76642336,27.00729927,37.22627737,284400
1084,95330,616,985,1601,839,948,3388,18.18181818,29.07319953,47.25501771,24.76387249,27.9811098,431400
1085,95333,38,81,119,89,141,349,10.88825215,23.20916905,34.0974212,25.50143266,40.40114613,274600
1086,95334,231,434,665,435,757,1857,12.43941842,23.37102854,35.81044696,23.42487884,40.76467421,246500
1087,95336,639,1521,2160,1557,2059,5776,11.06301939,26.33310249,37.39612188,26.95637119,35.64750693,398100
1088,95337,332,689,1021,622,670,2313,14.35365326,29.78815391,44.14180718,26.89148292,28.9667099,466500
1089,95338,76,160,236,174,224,634,11.9873817,25.23659306,37.22397476,27.44479495,35.33123028,320800
1090,95340,586,1239,1825,1416,2396,5637,10.3956005,21.97977648,32.37537697,25.11974454,42.50487848,300400
1091,95341,368,691,1059,830,1060,2949,12.47880638,23.43167175,35.91047813,28.14513394,35.94438793,232400
1092,95348,307,658,965,653,890,2508,12.24082935,26.23604466,38.476874,26.03668262,35.48644338,273400
1093,95350,803,1631,2434,1687,2502,6623,12.12441492,24.62630228,36.7507172,25.47184056,37.77744225,309800
1094,95351,346,875,1221,1167,2571,4959,6.977213148,17.64468643,24.62189958,23.53297036,51.84513007,241800
1095,95354,205,328,533,382,718,1633,12.55358236,20.08573178,32.63931415,23.39252909,43.96815677,280500
1096,95355,1129,1613,2742,1268,1718,5728,19.71019553,28.1599162,47.87011173,22.13687151,29.99301676,359200
1097,95356,379,494,873,412,421,1706,22.21570926,28.95662368,51.17233294,24.15005862,24.67760844,389900
1098,95357,166,372,538,423,581,1542,10.76523995,24.12451362,34.88975357,27.43190661,37.67833982,340300
1099,95358,345,687,1032,752,1410,3194,10.80150282,21.50907952,32.31058234,23.54414527,44.14527239,319900
1100,95360,156,405,561,466,597,1624,9.60591133,24.93842365,34.54433498,28.69458128,36.76108374,298300
1101,95361,490,728,1218,668,887,2773,17.67039308,26.25315543,43.9235485,24.08943383,31.98701767,407700
1102,95363,357,738,1095,793,1125,3013,11.84865582,24.49385994,36.34251577,26.31928311,37.33820113,360300
1103,95365,62,161,223,134,178,535,11.58878505,30.09345794,41.68224299,25.04672897,33.27102804,183900
1104,95366,610,798,1408,508,406,2322,26.2704565,34.36692506,60.63738157,21.87769165,17.48492679,522100
1105,95367,230,416,646,456,614,1716,13.4032634,24.24242424,37.64568765,26.57342657,35.78088578,344800
1106,95368,164,376,540,318,453,1311,12.50953471,28.68039664,41.18993135,24.25629291,34.55377574,349000
1107,95369,4,17,21,7,11,39,10.25641026,43.58974359,53.84615385,17.94871795,28.20512821,339200
1108,95370,203,389,592,314,441,1347,15.0705271,28.87899035,43.94951745,23.31106162,32.73942094,342700
1109,95372,37,76,113,93,105,311,11.89710611,24.43729904,36.33440514,29.90353698,33.76205788,317000
1110,95374,4,9,13,19,25,57,7.01754386,15.78947368,22.80701754,33.33333333,43.85964912,357300
1111,95376,841,1593,2434,1694,2489,6617,12.70968717,24.07435394,36.78404111,25.6007254,37.61523349,454200
1112,95377,464,647,1111,552,525,2188,21.20658135,29.57038391,50.77696527,25.2285192,23.99451554,594900
1113,95379,64,142,206,124,81,411,15.57177616,34.54987835,50.1216545,30.1703163,19.7080292,319000
1114,95380,405,744,1149,803,1351,3303,12.26158038,22.52497729,34.78655767,24.31123221,40.90221011,319900
1115,95382,650,1042,1692,892,1208,3792,17.14135021,27.47890295,44.62025316,23.52320675,31.85654008,374600
1116,95383,27,56,83,45,46,174,15.51724138,32.18390805,47.70114943,25.86206897,26.43678161,364200
1117,95386,189,428,617,374,536,1527,12.37721022,28.02881467,40.40602489,24.49246889,35.10150622,323200
1118,95387,11,31,42,31,78,151,7.284768212,20.52980132,27.81456954,20.52980132,51.65562914,445100
1119,95388,224,348,572,360,424,1356,16.51917404,25.66371681,42.18289086,26.54867257,31.26843658,231700
1120,95389,6,6,12,2,1,15,40,40,80,13.33333333,6.666666667,699100
1121,95391,1570,1147,2717,562,372,3651,43.00191728,31.4160504,74.41796768,15.393043,10.18898932,634300
1122,95401,319,546,865,575,812,2252,14.1651865,24.24511545,38.41030195,25.53285968,36.05683837,541300
1123,95403,239,481,720,596,935,2251,10.61750333,21.36828076,31.9857841,26.47712128,41.53709462,588800
1124,95404,213,412,625,382,630,1637,13.0116066,25.16799023,38.17959682,23.33536958,38.4850336,710100
1125,95405,434,671,1105,581,576,2262,19.18656057,29.66401415,48.85057471,25.68523431,25.46419098,648800
1126,95407,357,887,1244,1003,1342,3589,9.947060463,24.71440513,34.66146559,27.9465032,37.39203121,506600
1127,95409,656,665,1321,465,455,2241,29.27264614,29.67425257,58.94689871,20.74966533,20.30343597,665600
1128,95415,17,51,68,68,99,235,7.234042553,21.70212766,28.93617021,28.93617021,42.12765957,542200
1129,95421,1,6,7,2,2,11,9.090909091,54.54545455,63.63636364,18.18181818,18.18181818,571400
1130,95422,42,125,167,201,621,989,4.246713852,12.63902932,16.88574317,20.32355915,62.79069767,156400
1131,95423,6,16,22,31,60,113,5.309734513,14.15929204,19.46902655,27.43362832,53.09734513,223600
1132,95425,64,134,198,175,295,668,9.580838323,20.05988024,29.64071856,26.19760479,44.16167665,556700
1133,95426,13,20,33,23,16,72,18.05555556,27.77777778,45.83333333,31.94444444,22.22222222,260400
1134,95428,4,19,23,50,97,170,2.352941176,11.17647059,13.52941176,29.41176471,57.05882353,301300
1135,95436,24,50,74,51,41,166,14.45783133,30.12048193,44.57831325,30.72289157,24.69879518,578800
1136,95437,103,239,342,240,331,913,11.28148959,26.17743702,37.45892662,26.28696605,36.25410734,446400
1137,95441,7,20,27,31,39,97,7.216494845,20.6185567,27.83505155,31.95876289,40.20618557,952800
1138,95442,3,10,13,18,36,67,4.47761194,14.92537313,19.40298507,26.86567164,53.73134328,1177600
1139,95446,25,42,67,43,44,154,16.23376623,27.27272727,43.50649351,27.92207792,28.57142857,506700
1140,95448,151,225,376,199,199,774,19.50904393,29.06976744,48.57881137,25.71059432,25.71059432,919400
1141,95449,3,5,8,9,29,46,6.52173913,10.86956522,17.39130435,19.56521739,63.04347826,465000
1142,95451,48,178,226,231,436,893,5.375139978,19.93281075,25.30795073,25.86786114,48.82418813,285000
1143,95452,22,17,39,13,13,65,33.84615385,26.15384615,60,20,20,915600
1144,95453,61,118,179,170,282,631,9.667194929,18.70047544,28.36767036,26.94136292,44.69096672,342500
1145,95454,11,37,48,41,63,152,7.236842105,24.34210526,31.57894737,26.97368421,41.44736842,371700
1146,95457,37,113,150,170,400,720,5.138888889,15.69444444,20.83333333,23.61111111,55.55555556,332800
1147,95458,12,34,46,35,82,163,7.36196319,20.85889571,28.2208589,21.47239264,50.30674847,234500
1148,95459,2,2,4,5,6,15,13.33333333,13.33333333,26.66666667,33.33333333,40,539800
1149,95460,32,63,95,61,38,194,16.49484536,32.4742268,48.96907216,31.44329897,19.58762887,566400
1150,95461,64,143,207,153,158,518,12.35521236,27.60617761,39.96138996,29.53667954,30.5019305,315900
1151,95462,11,15,26,10,3,39,28.20512821,38.46153846,66.66666667,25.64102564,7.692307692,562500
1152,95465,38,34,72,27,11,110,34.54545455,30.90909091,65.45454545,24.54545455,10,957300
1153,95466,19,21,40,19,20,79,24.05063291,26.58227848,50.63291139,24.05063291,25.3164557,583300
1154,95467,34,55,89,68,64,221,15.38461538,24.88687783,40.27149321,30.76923077,28.95927602,338300
1155,95468,16,55,71,48,82,201,7.960199005,27.36318408,35.32338308,23.88059701,40.7960199,494100
1156,95469,13,32,45,48,55,148,8.783783784,21.62162162,30.40540541,32.43243243,37.16216216,485000
1157,95470,38,121,159,143,189,491,7.739307536,24.64358452,32.38289206,29.12423625,38.49287169,495100
1158,95472,532,641,1173,438,303,1914,27.79519331,33.49007315,61.28526646,22.88401254,15.830721,890700
1159,95476,232,484,716,509,622,1847,12.56090958,26.2046562,38.76556578,27.55820249,33.67623173,767900
1160,95482,296,581,877,702,1215,2794,10.59413028,20.79455977,31.38869005,25.12526843,43.48604152,402700
1161,95485,39,86,125,99,202,426,9.154929577,20.18779343,29.342723,23.23943662,47.41784038,299100
1162,95490,58,166,224,216,368,808,7.178217822,20.54455446,27.72277228,26.73267327,45.54455446,337600
1163,95492,327,574,901,615,751,2267,14.42434936,25.31980591,39.74415527,27.12836348,33.12748125,652800
1164,95501,185,340,525,313,416,1254,14.75279107,27.11323764,41.86602871,24.96012759,33.1738437,299400
1165,95503,227,487,714,476,645,1835,12.37057221,26.53950954,38.91008174,25.9400545,35.14986376,337600
1166,95519,119,237,356,199,250,805,14.7826087,29.44099379,44.22360248,24.72049689,31.05590062,352700
1167,95521,314,442,756,396,328,1480,21.21621622,29.86486486,51.08108108,26.75675676,22.16216216,379000
1168,95524,121,93,214,49,26,289,41.86851211,32.1799308,74.04844291,16.9550173,8.996539792,484900
1169,95525,12,22,34,41,42,117,10.25641026,18.8034188,29.05982906,35.04273504,35.8974359,388200
1170,95526,2,9,11,17,22,50,4,18,22,34,44,262100
1171,95527,13,17,30,7,7,44,29.54545455,38.63636364,68.18181818,15.90909091,15.90909091,272700
1172,95528,11,27,38,30,21,89,12.35955056,30.33707865,42.69662921,33.70786517,23.59550562,383900
1173,95531,162,374,536,433,786,1755,9.230769231,21.31054131,30.54131054,24.67236467,44.78632479,236100
1174,95536,33,80,113,69,65,247,13.36032389,32.38866397,45.74898785,27.93522267,26.31578947,443500
1175,95540,106,270,376,275,444,1095,9.680365297,24.65753425,34.33789954,25.11415525,40.54794521,313500
1176,95546,12,24,36,45,223,304,3.947368421,7.894736842,11.84210526,14.80263158,73.35526316,257500
1177,95547,35,41,76,27,20,123,28.45528455,33.33333333,61.78861789,21.95121951,16.2601626,470800
1178,95548,0,1,1,6,36,43,0,2.325581395,2.325581395,13.95348837,83.72093023,200500
1179,95549,2,8,10,7,4,21,9.523809524,38.0952381,47.61904762,33.33333333,19.04761905,536500
1180,95551,0,0,0,6,56,62,0,0,0,9.677419355,90.32258065,391100
1181,95555,1,4,5,3,5,13,7.692307692,30.76923077,38.46153846,23.07692308,38.46153846,325000
1182,95556,2,10,12,10,20,42,4.761904762,23.80952381,28.57142857,23.80952381,47.61904762,337600
1183,95558,8,2,10,6,1,17,47.05882353,11.76470588,58.82352941,35.29411765,5.882352941,708300
1184,95560,11,18,29,50,73,152,7.236842105,11.84210526,19.07894737,32.89473684,48.02631579,341200
1185,95562,11,29,40,64,73,177,6.214689266,16.38418079,22.59887006,36.15819209,41.24293785,239000
1186,95564,2,2,4,5,23,32,6.25,6.25,12.5,15.625,71.875,333300
1187,95565,13,35,48,23,48,119,10.92436975,29.41176471,40.33613445,19.32773109,40.33613445,284600
1188,95567,18,27,45,44,66,155,11.61290323,17.41935484,29.03225806,28.38709677,42.58064516,254000
1189,95570,21,36,57,23,42,122,17.21311475,29.50819672,46.72131148,18.85245902,34.42622951,446600
1190,95573,5,18,23,23,52,98,5.102040816,18.36734694,23.46938776,23.46938776,53.06122449,314200
1191,95585,3,7,10,8,14,32,9.375,21.875,31.25,25,43.75,356700
1192,95589,4,10,14,8,15,37,10.81081081,27.02702703,37.83783784,21.62162162,40.54054054,405300
1193,95603,392,521,913,428,559,1900,20.63157895,27.42105263,48.05263158,22.52631579,29.42105263,474900
1194,95605,92,198,290,257,469,1016,9.05511811,19.48818898,28.54330709,25.29527559,46.16141732,313500
1195,95608,1500,2056,3556,1842,2353,7751,19.35234163,26.5256096,45.87795123,23.76467553,30.35737324,448700
1196,95610,114,204,318,242,436,996,11.44578313,20.48192771,31.92771084,24.29718876,43.7751004,375700
1197,95612,72,116,188,131,106,425,16.94117647,27.29411765,44.23529412,30.82352941,24.94117647,853100
1198,95614,24,44,68,33,28,129,18.60465116,34.10852713,52.71317829,25.58139535,21.70542636,430400
1199,95615,7,18,25,26,17,68,10.29411765,26.47058824,36.76470588,38.23529412,25,602300
1200,95616,1451,1108,2559,595,517,3671,39.52601471,30.18251158,69.70852629,16.20811768,14.08335603,730800
1201,95618,98,122,220,65,65,350,28,34.85714286,62.85714286,18.57142857,18.57142857,697900
1202,95619,1,19,20,10,17,47,2.127659574,40.42553191,42.55319149,21.27659574,36.17021277,277300
1203,95620,202,388,590,422,674,1686,11.98102017,23.01304864,34.9940688,25.02965599,39.97627521,458600
1204,95621,197,424,621,509,657,1787,11.02406267,23.72691662,34.75097929,28.48349189,36.76552882,327900
1205,95623,104,153,257,73,69,399,26.06516291,38.34586466,64.41102757,18.29573935,17.29323308,443500
1206,95624,2189,2622,4811,1750,1650,8211,26.6593594,31.93277311,58.59213251,21.31287298,20.09499452,473300
1207,95626,10,37,47,47,64,158,6.329113924,23.41772152,29.74683544,29.74683544,40.50632911,396500
1208,95627,34,100,134,132,222,488,6.967213115,20.49180328,27.45901639,27.04918033,45.49180328,357900
1209,95628,518,767,1285,522,568,2375,21.81052632,32.29473684,54.10526316,21.97894737,23.91578947,489000
1210,95630,2768,1969,4737,955,603,6295,43.97140588,31.27879269,75.25019857,15.17077045,9.579030977,598100
1211,95631,56,109,165,67,72,304,18.42105263,35.85526316,54.27631579,22.03947368,23.68421053,409400
1212,95632,455,799,1254,688,729,2671,17.03481842,29.91388993,46.94870835,25.75814302,27.29314863,403000
1213,95633,13,76,89,71,73,233,5.579399142,32.61802575,38.19742489,30.472103,31.3304721,341700
1214,95634,35,70,105,69,101,275,12.72727273,25.45454545,38.18181818,25.09090909,36.72727273,323700
1215,95636,1,2,3,3,5,11,9.090909091,18.18181818,27.27272727,27.27272727,45.45454545,281900
1216,95638,35,83,118,83,95,296,11.82432432,28.04054054,39.86486486,28.04054054,32.09459459,585700
1217,95640,18,44,62,57,95,214,8.411214953,20.56074766,28.97196262,26.63551402,44.39252336,345100
1218,95641,25,19,44,29,19,92,27.17391304,20.65217391,47.82608696,31.52173913,20.65217391,259800
1219,95642,138,294,432,297,372,1101,12.53405995,26.70299728,39.23705722,26.97547684,33.78746594,348900
1220,95645,23,32,55,35,29,119,19.32773109,26.8907563,46.21848739,29.41176471,24.3697479,343700
1221,95648,1263,1677,2940,1187,1077,5204,24.26979247,32.22521138,56.49500384,22.8093774,20.69561875,514000
1222,95650,744,697,1441,337,193,1971,37.74733638,35.36276002,73.1100964,17.09791984,9.791983765,682700
1223,95655,110,68,178,83,73,334,32.93413174,20.35928144,53.29341317,24.8502994,21.85628743,433100
1224,95658,133,212,345,112,104,561,23.70766488,37.78966132,61.4973262,19.96434938,18.53832442,702600
1225,95659,266,484,750,360,351,1461,18.20670773,33.12799452,51.33470226,24.64065708,24.02464066,435700
1226,95660,244,547,791,590,1323,2704,9.023668639,20.22928994,29.25295858,21.81952663,48.92751479,256000
1227,95661,930,893,1823,631,519,2973,31.2815338,30.03699966,61.31853347,21.22435251,17.45711403,550300
1228,95662,610,961,1571,795,762,3128,19.50127877,30.72250639,50.22378517,25.41560102,24.36061381,408300
1229,95663,64,53,117,26,18,161,39.7515528,32.91925466,72.67080745,16.14906832,11.18012422,713900
1230,95666,15,20,35,28,31,94,15.95744681,21.27659574,37.23404255,29.78723404,32.9787234,288400
1231,95667,654,1041,1695,871,917,3483,18.77691645,29.88802756,48.66494401,25.00717772,26.32787827,434200
1232,95668,15,37,52,40,26,118,12.71186441,31.3559322,44.06779661,33.89830508,22.03389831,480000
1233,95669,10,21,31,37,41,109,9.174311927,19.26605505,28.44036697,33.94495413,37.6146789,459000
1234,95670,581,906,1487,874,1636,3997,14.53590193,22.66700025,37.20290218,21.8663998,40.93069802,375500
1235,95672,251,321,572,165,129,866,28.98383372,37.0669746,66.05080831,19.05311778,14.8960739,573400
1236,95673,258,619,877,583,787,2247,11.48197597,27.54784157,39.02981753,25.94570538,35.02447708,340100
1237,95674,7,26,33,26,19,78,8.974358974,33.33333333,42.30769231,33.33333333,24.35897436,456300
1238,95677,569,693,1262,433,330,2025,28.09876543,34.22222222,62.32098765,21.38271605,16.2962963,506800
1239,95678,723,1033,1756,770,797,3323,21.75744809,31.08636774,52.84381583,23.17183268,23.98435149,426500
1240,95681,2,8,10,5,15,30,6.666666667,26.66666667,33.33333333,16.66666667,50,312700
1241,95682,505,556,1061,368,246,1675,30.14925373,33.19402985,63.34328358,21.97014925,14.68656716,544400
1242,95683,82,62,144,37,33,214,38.31775701,28.97196262,67.28971963,17.28971963,15.42056075,550800
1243,95684,21,49,70,31,63,164,12.80487805,29.87804878,42.68292683,18.90243902,38.41463415,460700
1244,95685,95,122,217,104,121,442,21.49321267,27.60180995,49.09502262,23.52941176,27.37556561,447400
1245,95686,19,37,56,19,45,120,15.83333333,30.83333333,46.66666667,15.83333333,37.5,311000
1246,95687,585,1071,1656,943,1208,3807,15.36643026,28.13238771,43.49881797,24.77016023,31.7310218,459300
1247,95688,675,1047,1722,842,877,3441,19.61639058,30.42720139,50.04359198,24.46963092,25.4867771,563300
1248,95690,7,28,35,19,39,93,7.52688172,30.10752688,37.6344086,20.43010753,41.93548387,601900
1249,95691,618,946,1564,716,989,3269,18.90486387,28.93851331,47.84337718,21.90272255,30.25390028,412100
1250,95692,136,257,393,202,240,835,16.28742515,30.77844311,47.06586826,24.19161677,28.74251497,310900
1251,95693,63,78,141,47,47,235,26.80851064,33.19148936,60,20,20,657600
1252,95694,88,186,274,201,314,789,11.15335868,23.57414449,34.72750317,25.47528517,39.79721166,474000
1253,95695,447,883,1330,935,1438,3703,12.07129355,23.84553065,35.9168242,25.24979746,38.83337834,402800
1254,95697,0,4,4,14,45,63,0,6.349206349,6.349206349,22.22222222,71.42857143,170300
1255,95701,5,11,16,14,27,57,8.771929825,19.29824561,28.07017544,24.56140351,47.36842105,460400
1256,95709,65,85,150,71,50,271,23.98523985,31.36531365,55.35055351,26.19926199,18.4501845,465300
1257,95713,83,110,193,107,98,398,20.85427136,27.63819095,48.49246231,26.88442211,24.62311558,422400
1258,95722,12,15,27,19,26,72,16.66666667,20.83333333,37.5,26.38888889,36.11111111,547200
1259,95726,46,114,160,118,124,402,11.44278607,28.35820896,39.80099502,29.35323383,30.84577114,341300
1260,95742,436,327,763,190,168,1121,38.89384478,29.17038359,68.06422837,16.94915254,14.98661909,472200
1261,95746,721,513,1234,172,89,1495,48.22742475,34.31438127,82.54180602,11.50501672,5.953177258,852900
1262,95747,2237,2462,4699,1477,1180,7356,30.41054921,33.46927678,63.87982599,20.0788472,16.04132681,537300
1263,95757,2219,2153,4372,1204,896,6472,34.28615575,33.26637824,67.55253399,18.60321384,13.84425216,507100
1264,95758,1045,1283,2328,963,1179,4470,23.37807606,28.70246085,52.08053691,21.54362416,26.37583893,434500
1265,95762,2084,2236,4320,1397,1127,6844,30.45002922,32.67095266,63.12098188,20.41203974,16.46697838,699100
1266,95765,1809,1855,3664,1025,634,5323,33.98459515,34.84876949,68.83336464,19.25605861,11.91057674,578900
1267,95776,172,228,400,247,273,920,18.69565217,24.7826087,43.47826087,26.84782609,29.67391304,429900
1268,95814,21,29,50,35,66,151,13.90728477,19.20529801,33.11258278,23.17880795,43.70860927,544600
1269,95815,98,238,336,352,917,1605,6.105919003,14.82866044,20.93457944,21.93146417,57.13395639,247400
1270,95816,449,420,869,221,211,1301,34.51191391,32.28285934,66.79477325,16.98693313,16.21829362,631100
1271,95817,55,147,202,209,336,747,7.362784471,19.67871486,27.04149933,27.97858099,44.97991968,374200
1272,95818,510,550,1060,410,600,2070,24.63768116,26.57004831,51.20772947,19.80676329,28.98550725,660600
1273,95819,461,311,772,225,228,1225,37.63265306,25.3877551,63.02040816,18.36734694,18.6122449,637200
1274,95820,296,505,801,554,1046,2401,12.32819658,21.03290296,33.36109954,23.07371928,43.56518117,317700
1275,95821,435,619,1054,615,1211,2880,15.10416667,21.49305556,36.59722222,21.35416667,42.04861111,374500
1276,95822,377,588,965,688,1376,3029,12.44635193,19.41234731,31.85869924,22.71376692,45.42753384,355400
1277,95823,665,1468,2133,1826,3179,7138,9.316335108,20.56598487,29.88231998,25.58139535,44.53628467,285600
1278,95824,150,322,472,435,1162,2069,7.249879169,15.56307395,22.81295312,21.02464959,56.16239729,243800
1279,95825,39,98,137,236,724,1097,3.55515041,8.933454877,12.48860529,21.51321787,65.99817685,331300
1280,95826,293,545,838,534,881,2253,13.00488238,24.18996893,37.19485131,23.70173103,39.10341767,349300
1281,95827,82,210,292,246,516,1054,7.779886148,19.92409867,27.70398482,23.33965844,48.95635674,328800
1282,95828,498,910,1408,1096,1711,4215,11.81494662,21.58956109,33.40450771,26.00237248,40.59311981,309800
1283,95829,712,880,1592,601,664,2857,24.92124606,30.80154008,55.72278614,21.0360518,23.24116206,429800
1284,95831,521,733,1254,668,731,2653,19.6381455,27.62909913,47.26724463,25.17904259,27.55371278,485300
1285,95832,89,238,327,277,418,1022,8.708414873,23.28767123,31.99608611,27.1037182,40.90019569,319400
1286,95833,367,804,1171,860,1503,3534,10.38483305,22.75042445,33.1352575,24.33503113,42.52971138,349900
1287,95834,380,494,874,371,415,1660,22.89156627,29.75903614,52.65060241,22.34939759,25,415800
1288,95835,1143,1446,2589,1088,1360,5037,22.69207862,28.70756403,51.39964264,21.60015882,27.00019853,452000
1289,95838,291,752,1043,1110,2204,4357,6.678907505,17.25958228,23.93848979,25.47624512,50.58526509,276000
1290,95841,68,82,150,115,146,411,16.54501217,19.9513382,36.49635036,27.98053528,35.52311436,308800
1291,95842,249,436,685,431,776,1892,13.16067653,23.04439746,36.205074,22.78012685,41.01479915,289300
1292,95843,690,1076,1766,860,907,3533,19.53014435,30.45570337,49.98584772,24.34191905,25.67223323,361900
1293,95864,515,824,1339,586,788,2713,18.982676,30.37228161,49.35495761,21.59970512,29.04533727,643200
1294,95901,326,723,1049,821,1043,2913,11.19121181,24.81977343,36.01098524,28.18400275,35.80501202,269300
1295,95912,80,180,260,205,240,705,11.34751773,25.53191489,36.87943262,29.07801418,34.04255319,351000
1296,95914,7,15,22,20,13,55,12.72727273,27.27272727,40,36.36363636,23.63636364,306900
1297,95917,23,53,76,73,104,253,9.090909091,20.9486166,30.03952569,28.85375494,41.10671937,275000
1298,95918,26,25,51,13,12,76,34.21052632,32.89473684,67.10526316,17.10526316,15.78947368,532700
1299,95922,5,7,12,10,3,25,20,28,48,40,12,266200
1300,95926,1223,1441,2664,969,1162,4795,25.50573514,30.05213764,55.55787278,20.20855057,24.23357664,370500
1301,95928,622,763,1385,622,625,2632,23.63221884,28.9893617,52.62158055,23.63221884,23.74620061,388800
1302,95932,91,195,286,194,243,723,12.58644537,26.97095436,39.55739972,26.83264177,33.60995851,285200
1303,95936,3,0,3,1,8,12,25,0,25,8.333333333,66.66666667,1024200
1304,95938,98,150,248,127,134,509,19.25343811,29.46954813,48.72298625,24.95088409,26.32612967,477700
1305,95939,5,5,10,6,5,21,23.80952381,23.80952381,47.61904762,28.57142857,23.80952381,138100
1306,95942,10,22,32,19,14,65,15.38461538,33.84615385,49.23076923,29.23076923,21.53846154,392300
1307,95945,320,547,867,514,611,1992,16.06425703,27.45983936,43.52409639,25.80321285,30.67269076,391400
1308,95946,63,109,172,96,104,372,16.93548387,29.30107527,46.23655914,25.80645161,27.95698925,443600
1309,95947,3,8,11,16,14,41,7.317073171,19.51219512,26.82926829,39.02439024,34.14634146,240100
1310,95948,208,406,614,291,305,1210,17.19008264,33.55371901,50.74380165,24.04958678,25.20661157,260600
1311,95949,171,343,514,294,256,1064,16.07142857,32.23684211,48.30827068,27.63157895,24.06015038,448500
1312,95951,24,53,77,96,159,332,7.228915663,15.96385542,23.19277108,28.91566265,47.89156627,240300
1313,95953,229,387,616,388,347,1351,16.95040711,28.64544782,45.59585492,28.71946706,25.68467802,276300
1314,95954,24,31,55,56,121,232,10.34482759,13.36206897,23.70689655,24.13793103,52.15517241,194500
1315,95955,22,57,79,61,61,201,10.94527363,28.35820896,39.30348259,30.34825871,30.34825871,283100
1316,95957,154,362,516,294,352,1162,13.25301205,31.15318417,44.40619621,25.30120482,30.29259897,278300
1317,95959,298,421,719,334,294,1347,22.12323682,31.25463994,53.37787676,24.79584261,21.82628062,519400
1318,95961,369,761,1130,859,1297,3286,11.22945831,23.15885575,34.38831406,26.14120511,39.47048083,292400
1319,95962,2,12,14,21,48,83,2.409638554,14.45783133,16.86746988,25.30120482,57.8313253,297500
1320,95963,184,390,574,486,731,1791,10.27359017,21.77554439,32.04913456,27.13567839,40.81518705,278200
1321,95965,152,274,426,351,530,1307,11.6296863,20.96403979,32.59372609,26.85539403,40.55087988,216400
1322,95966,178,413,591,554,970,2115,8.41607565,19.52718676,27.94326241,26.19385343,45.86288416,244400
1323,95968,21,98,119,113,131,363,5.785123967,26.99724518,32.78236915,31.12947658,36.08815427,156800
1324,95969,67,139,206,167,173,546,12.27106227,25.45787546,37.72893773,30.58608059,31.68498168,300000
1325,95970,3,11,14,17,38,69,4.347826087,15.94202899,20.28985507,24.63768116,55.07246377,450000
1326,95971,55,167,222,133,112,467,11.77730193,35.76017131,47.53747323,28.47965739,23.98286938,266100
1327,95973,29,43,72,32,19,123,23.57723577,34.95934959,58.53658537,26.01626016,15.44715447,402600
1328,95979,1,10,11,2,7,20,5,50,55,10,35,250000
1329,95982,73,173,246,121,123,490,14.89795918,35.30612245,50.20408163,24.69387755,25.10204082,292700
1330,95987,37,129,166,182,347,695,5.323741007,18.56115108,23.88489209,26.18705036,49.92805755,310300
1331,95988,50,155,205,220,363,788,6.345177665,19.67005076,26.01522843,27.91878173,46.06598985,244100
1332,95991,438,951,1389,976,1661,4026,10.87928465,23.62146051,34.50074516,24.24242424,41.2568306,297900
1333,95993,532,781,1313,660,801,2774,19.17808219,28.15428983,47.33237203,23.79235761,28.87527037,353700
1334,96001,652,869,1521,605,588,2714,24.02358143,32.01915991,56.04274134,22.29182019,21.66543847,319700
1335,96002,340,698,1038,606,759,2403,14.14898044,29.04702455,43.19600499,25.2184769,31.5855181,280900
1336,96003,427,739,1166,687,785,2638,16.18650493,28.0136467,44.20015163,26.04245641,29.75739196,299600
1337,96007,184,325,509,365,511,1385,13.28519856,23.46570397,36.75090253,26.35379061,36.89530686,235900
1338,96008,47,62,109,58,43,210,22.38095238,29.52380952,51.9047619,27.61904762,20.47619048,197700
1339,96009,2,13,15,19,37,71,2.816901408,18.30985915,21.12676056,26.76056338,52.11267606,277800
1340,96013,10,57,67,64,132,263,3.802281369,21.6730038,25.47528517,24.33460076,50.19011407,169500
1341,96017,4,7,11,11,9,31,12.90322581,22.58064516,35.48387097,35.48387097,29.03225806,258300
1342,96019,106,168,274,198,270,742,14.28571429,22.64150943,36.92722372,26.68463612,36.38814016,219700
1343,96020,16,37,53,54,54,161,9.937888199,22.98136646,32.91925466,33.54037267,33.54037267,229200
1344,96021,120,322,442,453,877,1772,6.772009029,18.17155756,24.94356659,25.56433409,49.49209932,212900
1345,96022,304,471,775,384,363,1522,19.97371879,30.94612352,50.91984231,25.22996058,23.85019711,263300
1346,96023,1,3,4,2,6,12,8.333333333,25,33.33333333,16.66666667,50,120300
1347,96024,35,42,77,17,16,110,31.81818182,38.18181818,70,15.45454545,14.54545455,278800
1348,96025,0,11,11,17,36,64,0,17.1875,17.1875,26.5625,56.25,232200
1349,96027,23,22,45,32,25,102,22.54901961,21.56862745,44.11764706,31.37254902,24.50980392,240800
1350,96028,23,36,59,42,45,146,15.75342466,24.65753425,40.4109589,28.76712329,30.82191781,286100
1351,96029,4,11,15,6,14,35,11.42857143,31.42857143,42.85714286,17.14285714,40,311500
1352,96032,44,74,118,55,56,229,19.2139738,32.31441048,51.52838428,24.01746725,24.45414847,253400
1353,96033,1,6,7,6,2,15,6.666666667,40,46.66666667,40,13.33333333,130000
1354,96034,3,0,3,4,17,24,12.5,0,12.5,16.66666667,70.83333333,305300
1355,96035,10,34,44,57,144,245,4.081632653,13.87755102,17.95918367,23.26530612,58.7755102,223500
1356,96038,15,35,50,41,34,125,12,28,40,32.8,27.2,213900
1357,96039,1,12,13,17,45,75,1.333333333,16,17.33333333,22.66666667,60,143800
1358,96041,35,44,79,34,28,141,24.82269504,31.20567376,56.02836879,24.11347518,19.85815603,310100
1359,96044,3,6,9,7,6,22,13.63636364,27.27272727,40.90909091,31.81818182,27.27272727,177100
1360,96047,2,5,7,9,9,25,8,20,28,36,36,367600
1361,96048,14,21,35,8,6,49,28.57142857,42.85714286,71.42857143,16.32653061,12.24489796,330600
1362,96052,2,5,7,13,20,40,5,12.5,17.5,32.5,50,282500
1363,96055,54,138,192,92,118,402,13.43283582,34.32835821,47.76119403,22.88557214,29.35323383,229300
1364,96056,13,25,38,27,35,100,13,25,38,27,35,266500
1365,96057,4,17,21,12,8,41,9.756097561,41.46341463,51.2195122,29.26829268,19.51219512,237500
1366,96062,56,56,112,39,29,180,31.11111111,31.11111111,62.22222222,21.66666667,16.11111111,325000
1367,96064,35,68,103,79,94,276,12.68115942,24.63768116,37.31884058,28.62318841,34.05797101,199100
1368,96065,7,13,20,11,24,55,12.72727273,23.63636364,36.36363636,20,43.63636364,267700
1369,96067,98,170,268,152,197,617,15.88330632,27.55267423,43.43598055,24.63533225,31.9286872,320300
1370,96069,3,3,6,9,13,28,10.71428571,10.71428571,21.42857143,32.14285714,46.42857143,327000
1371,96073,231,246,477,169,127,773,29.8835705,31.8240621,61.7076326,21.86287193,16.42949547,451900
1372,96080,278,577,855,620,917,2392,11.62207358,24.12207358,35.74414716,25.91973244,38.3361204,250400
1373,96087,9,14,23,18,22,63,14.28571429,22.22222222,36.50793651,28.57142857,34.92063492,334500
1374,96088,5,15,20,32,76,128,3.90625,11.71875,15.625,25,59.375,257200
1375,96092,11,21,32,15,15,62,17.74193548,33.87096774,51.61290323,24.19354839,24.19354839,275000
1376,96093,63,82,145,74,60,279,22.58064516,29.390681,51.97132616,26.52329749,21.50537634,298300
1377,96094,38,82,120,113,134,367,10.35422343,22.34332425,32.69754768,30.79019074,36.51226158,248600
1378,96097,86,177,263,203,299,765,11.24183007,23.1372549,34.37908497,26.53594771,39.08496732,190300
1379,96101,45,87,132,137,153,422,10.66350711,20.61611374,31.27962085,32.46445498,36.25592417,145900
1380,96104,7,21,28,12,16,56,12.5,37.5,50,21.42857143,28.57142857,174400
1381,96107,18,36,54,24,13,91,19.78021978,39.56043956,59.34065934,26.37362637,14.28571429,245800
1382,96109,8,32,40,38,69,147,5.442176871,21.76870748,27.21088435,25.85034014,46.93877551,186400
1383,96114,19,55,74,66,84,224,8.482142857,24.55357143,33.03571429,29.46428571,37.5,295100
1384,96118,15,50,65,64,47,176,8.522727273,28.40909091,36.93181818,36.36363636,26.70454545,215000
1385,96120,4,5,9,6,15,30,13.33333333,16.66666667,30,20,50,375300
1386,96122,35,85,120,87,80,287,12.19512195,29.61672474,41.81184669,30.31358885,27.87456446,198000
1387,96130,126,262,388,309,434,1131,11.14058355,23.16534041,34.30592396,27.32095491,38.37312113,218100
1388,96134,12,44,56,67,85,208,5.769230769,21.15384615,26.92307692,32.21153846,40.86538462,130100
1389,96137,7,28,35,23,26,84,8.333333333,33.33333333,41.66666667,27.38095238,30.95238095,236300
1390,96143,40,33,73,27,68,168,23.80952381,19.64285714,43.45238095,16.07142857,40.47619048,542100
1391,96145,122,213,335,111,117,563,21.669627,37.8330373,59.5026643,19.71580817,20.78152753,785700
1392,96146,71,51,122,15,4,141,50.35460993,36.17021277,86.5248227,10.63829787,2.836879433,1203900
1393,96150,276,499,775,454,542,1771,15.58441558,28.17617165,43.76058724,25.63523433,30.60417843,488200
1394,96161,397,457,854,293,229,1376,28.85174419,33.2122093,62.06395349,21.29360465,16.64244186,653600
},,,,,,,,,,,,,