Index,Zip Code,Students Standard Exceeded_english2021,Students Standard Met_english2021,Students Standard Met and Above_english2021,Students Standard Nearly Met_english2021,Students Standard Not Met_english2021,Students with Scores_english2021,Percentage Standard Exceeded_english2021,Percentage Standard Met_english2021,Percentage Standard Met and Above_english2021,Percentage Standard Nearly Met_english2021,Percentage Standard Not Met_english2021,Median Mortgage
0,90001,33,103,136,135,112,383,8.61618799,26.89295039,35.50913838,35.24804178,29.24281984,425200
1,90002,5,32,37,18,42,97,5.154639175,32.98969072,38.1443299,18.55670103,43.29896907,411500
2,90003,61,110,171,133,245,549,11.11111111,20.03642987,31.14754098,24.22586521,44.62659381,430800
3,90004,26,35,61,26,21,108,24.07407407,32.40740741,56.48148148,24.07407407,19.44444444,1148400
4,90005,176,365,541,329,396,1266,13.90205371,28.83096367,42.73301738,25.98736177,31.27962085,964700
5,90006,39,45,84,21,14,119,32.77310924,37.81512605,70.58823529,17.64705882,11.76470588,716900
6,90007,140,261,401,265,353,1019,13.73895976,25.61334642,39.35230618,26.00588813,34.64180569,717300
7,90010,14,22,36,18,17,71,19.71830986,30.98591549,50.70422535,25.35211268,23.94366197,822100
8,90011,95,203,298,214,288,800,11.875,25.375,37.25,26.75,36,452100
9,90012,174,178,352,80,53,485,35.87628866,36.70103093,72.57731959,16.49484536,10.92783505,633000
10,90013,53,122,175,90,103,368,14.40217391,33.15217391,47.55434783,24.45652174,27.98913043,664800
11,90015,34,105,139,130,162,431,7.88863109,24.36194896,32.25058005,30.16241299,37.58700696,715000
12,90016,30,166,196,163,251,610,4.918032787,27.21311475,32.13114754,26.72131148,41.14754098,677500
13,90017,45,108,153,132,245,530,8.490566038,20.37735849,28.86792453,24.90566038,46.22641509,697100
14,90018,38,41,79,38,24,141,26.95035461,29.07801418,56.02836879,26.95035461,17.0212766,704300
15,90019,51,91,142,75,91,308,16.55844156,29.54545455,46.1038961,24.35064935,29.54545455,1033900
16,90020,36,117,153,127,161,441,8.163265306,26.53061224,34.69387755,28.79818594,36.50793651,650300
17,90021,1,11,12,24,51,87,1.149425287,12.64367816,13.79310345,27.5862069,58.62068966,1013900
18,90022,224,321,545,316,569,1430,15.66433566,22.44755245,38.11188811,22.0979021,39.79020979,471000
19,90023,29,43,72,62,102,236,12.28813559,18.22033898,30.50847458,26.27118644,43.22033898,479600
20,90025,250,301,551,148,121,820,30.48780488,36.70731707,67.19512195,18.04878049,14.75609756,905900
21,90026,61,172,233,187,287,707,8.628005658,24.3281471,32.95615276,26.44978784,40.59405941,962100
22,90027,137,96,233,40,17,290,47.24137931,33.10344828,80.34482759,13.79310345,5.862068966,1287200
23,90028,70,86,156,75,75,306,22.87581699,28.10457516,50.98039216,24.50980392,24.50980392,723000
24,90031,156,272,428,293,416,1137,13.72031662,23.92260334,37.64291996,25.76956904,36.58751099,616900
25,90032,67,112,179,62,37,278,24.10071942,40.28776978,64.38848921,22.30215827,13.30935252,605400
26,90033,305,364,669,261,312,1242,24.55716586,29.30756844,53.8647343,21.01449275,25.12077295,538900
27,90034,112,119,231,75,47,353,31.72804533,33.71104816,65.43909348,21.24645892,13.31444759,1152500
28,90035,95,62,157,32,23,212,44.81132075,29.24528302,74.05660377,15.09433962,10.8490566,1494600
29,90036,0,3,3,5,3,11,0,27.27272727,27.27272727,45.45454545,27.27272727,1634700
30,90037,50,85,135,108,138,381,13.12335958,22.30971129,35.43307087,28.34645669,36.22047244,502000
31,90040,44,120,164,148,321,633,6.951026856,18.95734597,25.90837283,23.3807267,50.71090047,452100
32,90041,96,110,206,96,119,421,22.80285036,26.12826603,48.93111639,22.80285036,28.26603325,886800
33,90042,71,105,176,64,38,278,25.53956835,37.76978417,63.30935252,23.02158273,13.66906475,731600
34,90043,82,231,313,257,408,978,8.384458078,23.6196319,32.00408998,26.27811861,41.71779141,684500
35,90044,11,23,34,34,52,120,9.166666667,19.16666667,28.33333333,28.33333333,43.33333333,461200
36,90045,209,174,383,136,106,625,33.44,27.84,61.28,21.76,16.96,1103500
37,90046,85,78,163,57,47,267,31.83520599,29.21348315,61.04868914,21.34831461,17.60299625,1290400
38,90047,113,194,307,197,333,837,13.50059737,23.17801673,36.6786141,23.53643967,39.78494624,519400
39,90057,66,129,195,106,164,465,14.19354839,27.74193548,41.93548387,22.79569892,35.2688172,576200
40,90059,100,127,227,90,44,361,27.70083102,35.1800554,62.88088643,24.93074792,12.18836565,415100
41,90061,7,26,33,30,18,81,8.641975309,32.09876543,40.74074074,37.03703704,22.22222222,438800
42,90062,6,21,27,40,93,160,3.75,13.125,16.875,25,58.125,550600
43,90063,87,149,236,188,166,590,14.74576271,25.25423729,40,31.86440678,28.13559322,481100
44,90064,4,8,12,6,7,25,16,32,48,24,28,1388300
45,90065,110,198,308,139,131,578,19.03114187,34.25605536,53.28719723,24.04844291,22.66435986,833400
46,90066,113,120,233,71,57,361,31.30193906,33.24099723,64.54293629,19.66759003,15.78947368,1282100
47,90201,424,826,1250,853,1668,3771,11.24370194,21.90400424,33.14770618,22.6199947,44.23229912,440500
48,90210,138,85,223,38,42,303,45.54455446,28.05280528,73.59735974,12.54125413,13.86138614,2000000
49,90211,157,94,251,64,40,355,44.22535211,26.47887324,70.70422535,18.02816901,11.26760563,2000000
50,90212,410,370,780,149,117,1046,39.19694073,35.37284895,74.56978967,14.24474187,11.18546845,2000000
51,90230,793,826,1619,496,384,2499,31.73269308,33.05322129,64.78591437,19.84793918,15.36614646,849200
52,90232,136,127,263,108,144,515,26.40776699,24.66019417,51.06796117,20.97087379,27.96116505,1219100
53,90245,687,602,1289,290,193,1772,38.76975169,33.97291196,72.74266366,16.36568849,10.89164786,1244200
54,90248,40,89,129,85,71,285,14.03508772,31.22807018,45.26315789,29.8245614,24.9122807,571200
55,90250,176,210,386,176,192,754,23.34217507,27.85145889,51.19363395,23.34217507,25.46419098,661400
56,90255,158,244,402,200,204,806,19.60297767,30.27295285,49.87593052,24.81389578,25.3101737,455000
57,90260,182,298,480,250,356,1086,16.7587477,27.44014733,44.19889503,23.02025783,32.78084715,597300
58,90262,459,1265,1724,1447,2894,6065,7.56801319,20.8573784,28.42539159,23.8582028,47.71640561,449600
59,90265,56,28,84,10,27,121,46.28099174,23.14049587,69.4214876,8.26446281,22.31404959,2000000
60,90266,46,25,71,7,1,79,58.2278481,31.64556962,89.87341772,8.860759494,1.265822785,2000000
61,90270,58,105,163,90,104,357,16.2464986,29.41176471,45.65826331,25.21008403,29.13165266,481800
62,90280,336,500,836,475,498,1809,18.57379768,27.63957988,46.21337756,26.25760088,27.52902156,470200
63,90291,142,60,202,31,28,261,54.40613027,22.98850575,77.39463602,11.87739464,10.72796935,1899800
64,90301,122,339,461,475,830,1766,6.908267271,19.19592299,26.10419026,26.89694224,46.9988675,547900
65,90302,216,407,623,437,663,1723,12.53627394,23.62159025,36.15786419,25.36273941,38.4793964,590000
66,90303,74,167,241,235,507,983,7.527975585,16.98880977,24.51678535,23.90640895,51.5768057,606100
67,90304,27,50,77,22,31,130,20.76923077,38.46153846,59.23076923,16.92307692,23.84615385,586600
68,90305,2,12,14,12,55,81,2.469135802,14.81481481,17.28395062,14.81481481,67.90123457,646500
69,90601,102,113,215,76,61,352,28.97727273,32.10227273,61.07954545,21.59090909,17.32954545,626500
70,90603,43,69,112,50,65,227,18.94273128,30.39647577,49.33920705,22.02643172,28.63436123,649600
71,90604,396,596,992,416,269,1677,23.61359571,35.53965414,59.15324985,24.80620155,16.0405486,591400
72,90605,218,185,403,92,72,567,38.44797178,32.62786596,71.07583774,16.22574956,12.6984127,556000
73,90606,136,272,408,223,327,958,14.19624217,28.39248434,42.58872651,23.2776618,34.13361169,509600
74,90620,62,61,123,57,76,256,24.21875,23.828125,48.046875,22.265625,29.6875,622700
75,90621,64,109,173,94,82,349,18.33810888,31.23209169,49.57020057,26.93409742,23.49570201,643200
76,90623,378,465,843,224,190,1257,30.07159905,36.9928401,67.06443914,17.82020684,15.11535402,739200
77,90630,1016,755,1771,291,221,2283,44.50284713,33.07052124,77.57336837,12.74638633,9.680245291,700100
78,90631,390,453,843,371,377,1591,24.51288498,28.47265871,52.98554368,23.3186675,23.69578881,628900
79,90638,47,12,59,1,0,60,78.33333333,20,98.33333333,1.666666667,0,630100
80,90640,506,1070,1576,1166,1822,4564,11.08676599,23.44434706,34.53111306,25.54776512,39.92112182,558600
81,90650,113,130,243,99,79,421,26.84085511,30.87885986,57.71971496,23.51543943,18.76484561,487800
82,90660,129,207,336,139,162,637,20.25117739,32.49607535,52.74725275,21.82103611,25.43171115,490300
83,90670,157,186,343,144,120,607,25.86490939,30.64250412,56.50741351,23.723229,19.7693575,492100
84,90701,13,12,25,3,2,30,43.33333333,40,83.33333333,10,6.666666667,635000
85,90703,317,85,402,10,2,414,76.57004831,20.53140097,97.10144928,2.415458937,0.483091787,762700
86,90704,16,30,46,40,53,139,11.51079137,21.58273381,33.09352518,28.77697842,38.1294964,863800
87,90706,33,19,52,2,2,56,58.92857143,33.92857143,92.85714286,3.571428571,3.571428571,535300
88,90710,101,159,260,88,120,468,21.58119658,33.97435897,55.55555556,18.8034188,25.64102564,523400
89,90712,117,214,331,207,210,748,15.64171123,28.60962567,44.2513369,27.67379679,28.07486631,622800
90,90713,222,266,488,167,133,788,28.17258883,33.75634518,61.92893401,21.1928934,16.87817259,638600
91,90715,8,4,12,1,2,15,53.33333333,26.66666667,80,6.666666667,13.33333333,555400
92,90716,4,3,7,3,2,12,33.33333333,25,58.33333333,25,16.66666667,442000
93,90720,395,221,616,74,36,726,54.4077135,30.44077135,84.84848485,10.19283747,4.958677686,1004200
94,90723,534,1399,1933,1541,2210,5684,9.3947924,24.61294863,34.00774103,27.1111893,38.88106967,411900
95,90731,66,106,172,66,45,283,23.32155477,37.45583039,60.77738516,23.32155477,15.90106007,657700
96,90744,149,176,325,128,160,613,24.30668842,28.71125612,53.01794454,20.88091354,26.10114192,471000
97,90745,87,148,235,126,115,476,18.27731092,31.09243697,49.3697479,26.47058824,24.15966387,516000
98,90746,13,17,30,6,7,43,30.23255814,39.53488372,69.76744186,13.95348837,16.27906977,585600
99,90755,61,167,228,198,254,680,8.970588235,24.55882353,33.52941176,29.11764706,37.35294118,553100
100,90802,74,186,260,195,346,801,9.238451935,23.22097378,32.45942572,24.34456929,43.19600499,460300
101,90803,265,250,515,119,88,722,36.70360111,34.62603878,71.32963989,16.48199446,12.18836565,943000
102,90804,306,472,778,359,389,1526,20.05242464,30.93053735,50.98296199,23.52555701,25.491481,541000
103,90805,164,574,738,651,1105,2494,6.575781877,23.01523657,29.59101844,26.10264635,44.3063352,469100
104,90806,22,73,95,86,105,286,7.692307692,25.52447552,33.21678322,30.06993007,36.71328671,568400
105,90807,310,427,737,325,278,1340,23.13432836,31.86567164,55,24.25373134,20.74626866,661100
106,90808,706,992,1698,563,388,2649,26.65156663,37.44809362,64.09966025,21.25330313,14.64703662,708300
107,90810,133,272,405,306,426,1137,11.69744943,23.92260334,35.62005277,26.91292876,37.46701847,464500
108,90813,355,382,737,325,388,1450,24.48275862,26.34482759,50.82758621,22.4137931,26.75862069,430500
109,90815,547,706,1253,292,236,1781,30.71308254,39.64065132,70.35373386,16.39528355,13.25098259,701600
110,91001,19,39,58,37,59,154,12.33766234,25.32467532,37.66233766,24.02597403,38.31168831,887100
111,91006,3,3,6,2,7,15,20,20,40,13.33333333,46.66666667,1074000
112,91007,288,165,453,86,86,625,46.08,26.4,72.48,13.76,13.76,1056600
113,91008,144,197,341,133,131,605,23.80165289,32.56198347,56.36363636,21.98347107,21.65289256,1414100
114,91010,236,321,557,281,384,1222,19.31260229,26.26841244,45.58101473,22.99509002,31.42389525,560900
115,91016,485,584,1069,509,624,2202,22.02543143,26.52134423,48.54677566,23.11534968,28.33787466,707400
116,91042,58,61,119,20,19,158,36.70886076,38.60759494,75.3164557,12.65822785,12.02531646,617400
117,91101,1,2,3,10,5,18,5.555555556,11.11111111,16.66666667,55.55555556,27.77777778,615200
118,91103,5,6,11,2,0,13,38.46153846,46.15384615,84.61538462,15.38461538,0,780200
119,91104,59,56,115,55,46,216,27.31481481,25.92592593,53.24074074,25.46296296,21.2962963,836500
120,91106,23,36,59,17,30,106,21.69811321,33.96226415,55.66037736,16.03773585,28.30188679,811200
121,91107,91,121,212,60,43,315,28.88888889,38.41269841,67.3015873,19.04761905,13.65079365,913700
122,91108,780,380,1160,153,88,1401,55.6745182,27.12348323,82.79800143,10.92077088,6.281227695,2000000
123,91201,10,8,18,4,4,26,38.46153846,30.76923077,69.23076923,15.38461538,15.38461538,916000
124,91202,80,92,172,88,88,348,22.98850575,26.43678161,49.42528736,25.28735632,25.28735632,876700
125,91205,79,114,193,84,94,371,21.29380054,30.7277628,52.02156334,22.64150943,25.33692722,677200
126,91206,0,8,8,22,37,67,0,11.94029851,11.94029851,32.8358209,55.2238806,910500
127,91214,445,264,709,91,43,843,52.78766311,31.31672598,84.10438909,10.79478055,5.100830368,851700
128,91301,441,414,855,220,153,1228,35.91205212,33.71335505,69.62540717,17.91530945,12.45928339,871000
129,91302,515,639,1154,298,165,1617,31.84910328,39.51762523,71.36672851,18.42918986,10.20408163,1341400
130,91303,38,58,96,45,56,197,19.2893401,29.44162437,48.73096447,22.84263959,28.42639594,536400
131,91311,119,157,276,106,64,446,26.68161435,35.20179372,61.88340807,23.76681614,14.34977578,679000
132,91320,73,40,113,21,14,148,49.32432432,27.02702703,76.35135135,14.18918919,9.459459459,755800
133,91321,291,354,645,342,483,1470,19.79591837,24.08163265,43.87755102,23.26530612,32.85714286,513500
134,91324,4,26,30,27,68,125,3.2,20.8,24,21.6,54.4,680200
135,91325,36,47,83,38,29,150,24,31.33333333,55.33333333,25.33333333,19.33333333,720900
136,91331,36,98,134,144,304,582,6.18556701,16.83848797,23.02405498,24.74226804,52.23367698,487600
137,91335,414,289,703,194,173,1070,38.69158879,27.00934579,65.70093458,18.13084112,16.1682243,580500
138,91340,126,300,426,269,223,918,13.7254902,32.67973856,46.40522876,29.30283224,24.291939,515000
139,91342,212,513,725,508,688,1921,11.03591879,26.70484123,37.74076002,26.44456012,35.81467985,520900
140,91343,124,269,393,233,369,995,12.46231156,27.03517588,39.49748744,23.41708543,37.08542714,608500
141,91344,135,175,310,129,130,569,23.7258348,30.75571178,54.48154657,22.67135325,22.84710018,690300
142,91352,121,178,299,206,320,825,14.66666667,21.57575758,36.24242424,24.96969697,38.78787879,584100
143,91355,315,238,553,127,131,811,38.84093711,29.34648582,68.18742293,15.65967941,16.15289766,600200
144,91360,165,121,286,87,57,430,38.37209302,28.13953488,66.51162791,20.23255814,13.25581395,735100
145,91361,347,375,722,286,309,1317,26.34776006,28.4738041,54.82156416,21.71602126,23.46241458,1042900
146,91362,274,170,444,98,50,592,46.28378378,28.71621622,75,16.55405405,8.445945946,878300
147,91364,329,322,651,218,176,1045,31.48325359,30.81339713,62.29665072,20.86124402,16.84210526,949000
148,91367,215,216,431,136,94,661,32.52647504,32.67776097,65.20423601,20.57488654,14.22087746,786200
149,91377,1020,693,1713,268,141,2122,48.06786051,32.65786993,80.72573044,12.62959472,6.644674835,823300
150,91381,615,289,904,127,89,1120,54.91071429,25.80357143,80.71428571,11.33928571,7.946428571,851300
151,91401,71,108,179,91,85,355,20,30.42253521,50.42253521,25.63380282,23.94366197,798900
152,91402,48,59,107,47,68,222,21.62162162,26.57657658,48.1981982,21.17117117,30.63063063,483700
153,91403,13,44,57,36,51,144,9.027777778,30.55555556,39.58333333,25,35.41666667,1129100
154,91405,82,183,265,130,129,524,15.64885496,34.92366412,50.57251908,24.80916031,24.61832061,581600
155,91406,244,294,538,228,149,915,26.66666667,32.13114754,58.79781421,24.91803279,16.28415301,608600
156,91411,113,115,228,100,81,409,27.62836186,28.11735941,55.74572127,24.44987775,19.80440098,759300
157,91501,52,74,126,52,80,258,20.15503876,28.68217054,48.8372093,20.15503876,31.00775194,827400
158,91502,32,18,50,15,4,69,46.37681159,26.08695652,72.46376812,21.73913043,5.797101449,761400
159,91504,94,107,201,66,80,347,27.08933718,30.83573487,57.92507205,19.02017291,23.05475504,819100
160,91505,166,161,327,107,89,523,31.73996176,30.78393881,62.52390057,20.45889101,17.01720841,812500
161,91506,187,218,405,114,136,655,28.54961832,33.28244275,61.83206107,17.40458015,20.76335878,850600
162,91601,299,163,462,102,76,640,46.71875,25.46875,72.1875,15.9375,11.875,744500
163,91602,2,2,4,5,2,11,18.18181818,18.18181818,36.36363636,45.45454545,18.18181818,873700
164,91701,300,190,490,90,32,612,49.01960784,31.04575163,80.06535948,14.70588235,5.22875817,577200
165,91706,826,1534,2360,1546,2306,6212,13.29684482,24.69414037,37.99098519,24.88731487,37.12169994,465900
166,91709,155,117,272,70,48,390,39.74358974,30,69.74358974,17.94871795,12.30769231,676800
167,91710,31,44,75,49,28,152,20.39473684,28.94736842,49.34210526,32.23684211,18.42105263,512600
168,91711,78,49,127,15,8,150,52,32.66666667,84.66666667,10,5.333333333,714400
169,91724,35,65,100,42,28,170,20.58823529,38.23529412,58.82352941,24.70588235,16.47058824,613400
170,91737,197,130,327,62,34,423,46.57210402,30.73286052,77.30496454,14.6572104,8.037825059,659500
171,91739,171,147,318,104,65,487,35.11293634,30.18480493,65.29774127,21.35523614,13.34702259,648400
172,91744,71,109,180,83,64,327,21.71253823,33.33333333,55.04587156,25.382263,19.57186544,463200
173,91746,40,58,98,55,51,204,19.60784314,28.43137255,48.03921569,26.96078431,25,488400
174,91748,150,123,273,61,65,399,37.59398496,30.82706767,68.42105263,15.28822055,16.29072682,663600
175,91750,0,0,0,1,26,27,0,0,0,3.703703704,96.2962963,630400
176,91754,32,38,70,46,79,195,16.41025641,19.48717949,35.8974359,23.58974359,40.51282051,687700
177,91755,95,171,266,135,167,568,16.72535211,30.1056338,46.83098592,23.76760563,29.40140845,639900
178,91761,76,66,142,46,25,213,35.68075117,30.98591549,66.66666667,21.59624413,11.7370892,452900
179,91762,165,227,392,164,121,677,24.37223043,33.53028065,57.90251108,24.22451994,17.87296898,437700
180,91763,77,127,204,80,32,316,24.36708861,40.18987342,64.55696203,25.3164557,10.12658228,423700
181,91764,0,4,4,3,5,12,0,33.33333333,33.33333333,25,41.66666667,415600
182,91765,240,130,370,54,43,467,51.39186296,27.8372591,79.22912206,11.56316916,9.207708779,709800
183,91766,24,146,170,118,202,490,4.897959184,29.79591837,34.69387755,24.08163265,41.2244898,452700
184,91767,33,102,135,153,302,590,5.593220339,17.28813559,22.88135593,25.93220339,51.18644068,449500
185,91768,78,72,150,46,44,240,32.5,30,62.5,19.16666667,18.33333333,427500
186,91770,46,39,85,45,50,180,25.55555556,21.66666667,47.22222222,25,27.77777778,601300
187,91773,9,7,16,1,10,27,33.33333333,25.92592593,59.25925926,3.703703704,37.03703704,625400
188,91776,127,64,191,28,17,236,53.81355932,27.11864407,80.93220339,11.86440678,7.203389831,698900
189,91789,269,133,402,61,42,505,53.26732673,26.33663366,79.6039604,12.07920792,8.316831683,790500
190,91905,6,9,15,23,42,80,7.5,11.25,18.75,28.75,52.5,280400
191,91906,12,69,81,65,123,269,4.460966543,25.65055762,30.11152416,24.16356877,45.72490706,282800
192,91910,738,1355,2093,895,906,3894,18.95223421,34.79712378,53.74935799,22.98407807,23.26656394,549100
193,91911,158,329,487,318,413,1218,12.97208539,27.01149425,39.98357964,26.10837438,33.90804598,485300
194,91913,385,370,755,168,133,1056,36.45833333,35.03787879,71.49621212,15.90909091,12.59469697,578600
195,91914,286,514,800,282,272,1354,21.1225997,37.96159527,59.08419498,20.82717873,20.08862629,739300
196,91915,324,157,481,48,26,555,58.37837838,28.28828829,86.66666667,8.648648649,4.684684685,604600
197,91916,14,24,38,23,38,99,14.14141414,24.24242424,38.38383838,23.23232323,38.38383838,479600
198,91932,132,278,410,361,684,1455,9.072164948,19.10652921,28.17869416,24.81099656,47.01030928,639200
199,91935,29,62,91,53,48,192,15.10416667,32.29166667,47.39583333,27.60416667,25,681300
200,91941,62,96,158,78,75,311,19.93569132,30.8681672,50.80385852,25.08038585,24.11575563,684900
201,91942,28,35,63,32,37,132,21.21212121,26.51515152,47.72727273,24.24242424,28.03030303,578600
202,91950,184,573,757,595,777,2129,8.64255519,26.91404415,35.55659934,27.94739314,36.49600752,450700
203,91962,33,68,101,85,84,270,12.22222222,25.18518519,37.40740741,31.48148148,31.11111111,433300
204,91963,6,19,25,24,104,153,3.921568627,12.41830065,16.33986928,15.68627451,67.97385621,350000
205,91977,103,167,270,115,68,453,22.73730684,36.86534216,59.60264901,25.38631347,15.01103753,493000
206,91978,121,139,260,93,37,390,31.02564103,35.64102564,66.66666667,23.84615385,9.487179487,454100
207,92003,25,22,47,13,7,67,37.31343284,32.8358209,70.14925373,19.40298507,10.44776119,720300
208,92004,11,30,41,29,39,109,10.09174312,27.52293578,37.6146789,26.60550459,35.77981651,320600
209,92019,712,892,1604,638,445,2687,26.49795311,33.19687384,59.69482694,23.74395236,16.56122069,576700
210,92020,478,548,1026,401,267,1694,28.21723731,32.34946871,60.56670602,23.67178276,15.76151122,576200
211,92021,57,94,151,113,110,374,15.24064171,25.13368984,40.37433155,30.21390374,29.41176471,469100
212,92024,109,102,211,40,27,278,39.20863309,36.69064748,75.89928058,14.38848921,9.712230216,1063400
213,92025,96,147,243,96,74,413,23.24455206,35.59322034,58.8377724,23.24455206,17.91767554,558600
214,92026,88,129,217,106,79,402,21.89054726,32.08955224,53.9800995,26.3681592,19.65174129,539900
215,92027,365,582,947,474,276,1697,21.50854449,34.29581615,55.80436064,27.93164408,16.26399529,493300
216,92028,80,128,208,81,66,355,22.53521127,36.05633803,58.5915493,22.81690141,18.5915493,627900
217,92029,77,64,141,35,9,185,41.62162162,34.59459459,76.21621622,18.91891892,4.864864865,690900
218,92036,13,22,35,7,20,62,20.96774194,35.48387097,56.4516129,11.29032258,32.25806452,425900
219,92040,45,95,140,81,66,287,15.67944251,33.1010453,48.7804878,28.22299652,22.99651568,540200
220,92054,44,72,116,66,83,265,16.60377358,27.16981132,43.77358491,24.90566038,31.32075472,648800
221,92056,11,26,37,37,43,117,9.401709402,22.22222222,31.62393162,31.62393162,36.75213675,583700
222,92057,295,288,583,179,110,872,33.83027523,33.02752294,66.85779817,20.52752294,12.6146789,530600
223,92061,4,14,18,34,52,104,3.846153846,13.46153846,17.30769231,32.69230769,50,611500
224,92064,413,552,965,455,415,1835,22.50681199,30.08174387,52.58855586,24.79564033,22.61580381,767500
225,92065,85,110,195,52,49,296,28.71621622,37.16216216,65.87837838,17.56756757,16.55405405,593100
226,92067,224,121,345,58,10,413,54.23728814,29.29782082,83.53510896,14.04358354,2.421307506,2000000
227,92070,9,6,15,3,0,18,50,33.33333333,83.33333333,16.66666667,0,335700
228,92071,920,1326,2246,943,740,3929,23.41562739,33.74904556,57.16467294,24.00101807,18.83430898,524100
229,92078,8,5,13,4,3,20,40,25,65,20,15,665300
230,92081,125,154,279,78,64,421,29.6912114,36.57957245,66.27078385,18.52731591,15.20190024,599400
231,92082,180,383,563,371,640,1574,11.43583227,24.33290978,35.76874206,23.57052097,40.66073698,620700
232,92083,2,10,12,14,37,63,3.174603175,15.87301587,19.04761905,22.22222222,58.73015873,467600
233,92084,74,117,191,128,113,432,17.12962963,27.08333333,44.21296296,29.62962963,26.15740741,600600
234,92086,1,5,6,6,16,28,3.571428571,17.85714286,21.42857143,21.42857143,57.14285714,265800
235,92101,51,107,158,118,154,430,11.86046512,24.88372093,36.74418605,27.44186047,35.81395349,626000
236,92102,75,256,331,297,330,958,7.828810021,26.7223382,34.55114823,31.00208768,34.44676409,477100
237,92103,38,51,89,32,18,139,27.3381295,36.69064748,64.02877698,23.02158273,12.94964029,835300
238,92105,17,41,58,29,31,118,14.40677966,34.74576271,49.15254237,24.57627119,26.27118644,459200
239,92108,13,38,51,30,19,100,13,38,51,30,19,469300
240,92111,124,157,281,135,138,554,22.38267148,28.33935018,50.72202166,24.36823105,24.90974729,604600
241,92113,2,16,18,18,68,104,1.923076923,15.38461538,17.30769231,17.30769231,65.38461538,406600
242,92114,40,81,121,119,147,387,10.33591731,20.93023256,31.26614987,30.74935401,37.98449612,461500
243,92115,20,83,103,129,145,377,5.305039788,22.01591512,27.32095491,34.21750663,38.46153846,580800
244,92118,465,441,906,177,89,1172,39.67576792,37.62798635,77.30375427,15.10238908,7.593856655,1656900
245,92122,16,8,24,2,2,28,57.14285714,28.57142857,85.71428571,7.142857143,7.142857143,780000
246,92123,162,162,324,114,111,549,29.50819672,29.50819672,59.01639344,20.76502732,20.21857923,600900
247,92131,40,34,74,24,20,118,33.89830508,28.81355932,62.71186441,20.33898305,16.94915254,885500
248,92154,460,927,1387,1066,1957,4410,10.430839,21.02040816,31.45124717,24.1723356,44.37641723,477900
249,92173,8,22,30,52,265,347,2.305475504,6.340057637,8.645533141,14.98559078,76.36887608,388700
250,92201,117,224,341,264,347,952,12.28991597,23.52941176,35.81932773,27.73109244,36.44957983,272400
251,92223,393,744,1137,625,666,2428,16.18616145,30.64250412,46.82866557,25.74135091,27.42998353,354000
252,92227,92,157,249,141,106,496,18.5483871,31.65322581,50.2016129,28.42741935,21.37096774,226700
253,92231,148,180,328,135,217,680,21.76470588,26.47058824,48.23529412,19.85294118,31.91176471,233300
254,92233,41,98,139,147,218,504,8.134920635,19.44444444,27.57936508,29.16666667,43.25396825,158400
255,92234,100,169,269,167,259,695,14.38848921,24.31654676,38.70503597,24.02877698,37.26618705,325200
256,92236,222,712,934,936,1864,3734,5.945366899,19.06802357,25.01339047,25.06695233,49.9196572,262300
257,92240,28,60,88,49,38,175,16,34.28571429,50.28571429,28,21.71428571,230300
258,92243,357,547,904,412,454,1770,20.16949153,30.9039548,51.07344633,23.27683616,25.64971751,216700
259,92249,111,198,309,211,279,799,13.89236546,24.78097622,38.67334168,26.40801001,34.91864831,220200
260,92250,21,35,56,30,36,122,17.21311475,28.68852459,45.90163934,24.59016393,29.50819672,234300
261,92251,248,598,846,570,508,1924,12.88981289,31.08108108,43.97089397,29.62577963,26.4033264,271600
262,92252,8,21,29,38,75,142,5.633802817,14.78873239,20.42253521,26.76056338,52.81690141,217900
263,92253,161,186,347,138,80,565,28.49557522,32.92035398,61.4159292,24.42477876,14.15929204,453600
264,92254,40,131,171,193,585,949,4.214963119,13.80400421,18.01896733,20.33719705,61.64383562,160400
265,92257,1,4,5,6,19,30,3.333333333,13.33333333,16.66666667,20,63.33333333,57800
266,92260,308,196,504,142,106,752,40.95744681,26.06382979,67.0212766,18.88297872,14.09574468,363400
267,92262,85,83,168,85,75,328,25.91463415,25.30487805,51.2195122,25.91463415,22.86585366,447800
268,92264,5,10,15,10,11,36,13.88888889,27.77777778,41.66666667,27.77777778,30.55555556,386800
269,92270,43,76,119,91,101,311,13.82636656,24.43729904,38.26366559,29.26045016,32.47588424,570400
270,92273,10,40,50,51,146,247,4.048582996,16.19433198,20.24291498,20.64777328,59.10931174,158800
271,92274,130,475,605,560,1089,2254,5.767524401,21.07364685,26.84117125,24.8447205,48.31410825,113200
272,92275,15,50,65,88,245,398,3.768844221,12.56281407,16.33165829,22.11055276,61.55778894,145600
273,92277,83,157,240,139,172,551,15.06352087,28.49364791,43.55716878,25.22686025,31.21597096,158900
274,92281,5,39,44,72,112,228,2.192982456,17.10526316,19.29824561,31.57894737,49.12280702,160600
275,92284,49,111,160,116,133,409,11.9804401,27.1393643,39.1198044,28.36185819,32.51833741,225100
276,92301,20,43,63,57,111,231,8.658008658,18.61471861,27.27272727,24.67532468,48.05194805,238600
277,92307,48,35,83,10,6,99,48.48484848,35.35353535,83.83838384,10.1010101,6.060606061,301700
278,92309,2,14,16,10,33,59,3.389830508,23.72881356,27.11864407,16.94915254,55.93220339,86300
279,92311,135,451,586,570,1476,2632,5.129179331,17.13525836,22.26443769,21.65653495,56.07902736,144900
280,92313,97,206,303,171,243,717,13.52859135,28.73082287,42.25941423,23.84937238,33.89121339,378100
281,92314,51,65,116,48,65,229,22.27074236,28.38427948,50.65502183,20.96069869,28.38427948,307100
282,92315,110,179,289,220,238,747,14.72556894,23.96251673,38.68808568,29.45113788,31.86077644,467800
283,92316,169,430,599,396,585,1580,10.69620253,27.21518987,37.91139241,25.06329114,37.02531646,339100
284,92324,109,309,418,346,393,1157,9.420916162,26.70700086,36.12791703,29.90492653,33.96715644,326000
285,92327,9,16,25,22,20,67,13.43283582,23.88059701,37.31343284,32.8358209,29.85074627,151700
286,92335,21,49,70,17,2,89,23.59550562,55.05617978,78.65168539,19.1011236,2.247191011,344200
287,92336,18,21,39,18,10,67,26.86567164,31.34328358,58.20895522,26.86567164,14.92537313,460100
288,92337,74,146,220,160,83,463,15.98272138,31.53347732,47.5161987,34.55723542,17.92656587,403600
289,92339,10,27,37,6,3,46,21.73913043,58.69565217,80.43478261,13.04347826,6.52173913,335700
290,92342,57,159,216,154,210,580,9.827586207,27.4137931,37.24137931,26.55172414,36.20689655,266100
291,92344,66,119,185,130,149,464,14.22413793,25.64655172,39.87068966,28.01724138,32.11206897,345700
292,92345,217,610,827,659,836,2322,9.345391904,26.2704565,35.61584841,28.38070629,36.00344531,277100
293,92346,33,109,142,152,176,470,7.021276596,23.19148936,30.21276596,32.34042553,37.44680851,367300
294,92352,69,161,230,200,224,654,10.55045872,24.617737,35.16819572,30.58103976,34.25076453,457800
295,92356,218,422,640,389,389,1418,15.37376587,29.76022567,45.13399154,27.43300423,27.43300423,169100
296,92363,4,38,42,65,65,172,2.325581395,22.09302326,24.41860465,37.79069767,37.79069767,125400
297,92365,3,9,12,10,21,43,6.976744186,20.93023256,27.90697674,23.25581395,48.8372093,117600
298,92368,9,21,30,29,23,82,10.97560976,25.6097561,36.58536585,35.36585366,28.04878049,259800
299,92376,101,237,338,259,265,862,11.71693735,27.49419954,39.21113689,30.04640371,30.7424594,332100
300,92377,95,137,232,87,57,376,25.26595745,36.43617021,61.70212766,23.13829787,15.15957447,418300
301,92391,2,27,29,30,52,111,1.801801802,24.32432432,26.12612613,27.02702703,46.84684685,277100
302,92399,329,314,643,179,149,971,33.88259526,32.33779609,66.22039135,18.4346035,15.34500515,368400
303,92404,20,37,57,48,147,252,7.936507937,14.68253968,22.61904762,19.04761905,58.33333333,289900
304,92405,23,25,48,2,0,50,46,50,96,4,0,277800
305,92410,30,45,75,52,76,203,14.77832512,22.16748768,36.94581281,25.61576355,37.43842365,207500
306,92501,3,35,38,75,102,215,1.395348837,16.27906977,17.6744186,34.88372093,47.44186047,358700
307,92530,30,85,115,91,80,286,10.48951049,29.72027972,40.20979021,31.81818182,27.97202797,368200
308,92532,40,56,96,32,29,157,25.47770701,35.66878981,61.14649682,20.38216561,18.47133758,413400
309,92539,9,21,30,11,15,56,16.07142857,37.5,53.57142857,19.64285714,26.78571429,242300
310,92543,48,24,72,29,49,150,32,16,48,19.33333333,32.66666667,169000
311,92544,64,125,189,118,128,435,14.71264368,28.73563218,43.44827586,27.12643678,29.42528736,271700
312,92545,81,127,208,131,171,510,15.88235294,24.90196078,40.78431373,25.68627451,33.52941176,252000
313,92553,22,56,78,65,151,294,7.482993197,19.04761905,26.53061224,22.10884354,51.36054422,321800
314,92555,14,6,20,5,0,25,56,24,80,20,0,403300
315,92562,6,5,11,14,7,32,18.75,15.625,34.375,43.75,21.875,478500
316,92567,64,50,114,27,12,153,41.83006536,32.67973856,74.50980392,17.64705882,7.843137255,379400
317,92570,78,264,342,290,374,1006,7.753479125,26.24254473,33.99602386,28.82703777,37.17693837,326200
318,92571,38,79,117,65,58,240,15.83333333,32.91666667,48.75,27.08333333,24.16666667,336100
319,92583,185,366,551,365,421,1337,13.83694839,27.37471952,41.21166791,27.29992521,31.48840688,251700
320,92584,166,157,323,81,61,465,35.69892473,33.76344086,69.46236559,17.41935484,13.11827957,422000
321,92585,108,171,279,121,89,489,22.08588957,34.96932515,57.05521472,24.74437628,18.200409,371400
322,92590,133,158,291,98,106,495,26.86868687,31.91919192,58.78787879,19.7979798,21.41414141,1071800
323,92592,68,104,172,121,78,371,18.32884097,28.03234501,46.36118598,32.61455526,21.02425876,522400
324,92595,67,152,219,130,155,504,13.29365079,30.15873016,43.45238095,25.79365079,30.75396825,417300
325,92596,190,232,422,97,66,585,32.47863248,39.65811966,72.13675214,16.58119658,11.28205128,475400
326,92602,331,196,527,87,56,670,49.40298507,29.25373134,78.65671642,12.98507463,8.358208955,933600
327,92604,298,168,466,71,51,588,50.68027211,28.57142857,79.25170068,12.07482993,8.673469388,818400
328,92606,317,211,528,94,86,708,44.7740113,29.80225989,74.57627119,13.27683616,12.14689266,853800
329,92612,199,89,288,35,18,341,58.35777126,26.09970674,84.45747801,10.26392962,5.278592375,789000
330,92618,131,72,203,18,18,239,54.81171548,30.12552301,84.93723849,7.531380753,7.531380753,960800
331,92620,232,89,321,37,30,388,59.79381443,22.93814433,82.73195876,9.536082474,7.731958763,982000
332,92626,96,94,190,64,26,280,34.28571429,33.57142857,67.85714286,22.85714286,9.285714286,842500
333,92627,66,120,186,100,89,375,17.6,32,49.6,26.66666667,23.73333333,842100
334,92629,131,127,258,66,49,373,35.12064343,34.04825737,69.1689008,17.69436997,13.13672922,981600
335,92630,177,123,300,45,43,388,45.6185567,31.70103093,77.31958763,11.59793814,11.08247423,694800
336,92646,211,115,326,49,22,397,53.14861461,28.96725441,82.11586902,12.34256927,5.541561713,814900
337,92647,39,58,97,23,21,141,27.65957447,41.13475177,68.79432624,16.31205674,14.89361702,793300
338,92648,247,113,360,38,16,414,59.66183575,27.29468599,86.95652174,9.178743961,3.8647343,985800
339,92649,186,101,287,32,25,344,54.06976744,29.36046512,83.43023256,9.302325581,7.26744186,885000
340,92653,119,107,226,52,35,313,38.01916933,34.18530351,72.20447284,16.61341853,11.18210863,771800
341,92656,309,275,584,156,81,821,37.63702801,33.49573691,71.13276492,19.00121803,9.866017052,679300
342,92660,155,167,322,116,117,555,27.92792793,30.09009009,58.01801802,20.9009009,21.08108108,1905400
343,92663,136,140,276,83,57,416,32.69230769,33.65384615,66.34615385,19.95192308,13.70192308,1590000
344,92673,254,186,440,69,55,564,45.03546099,32.9787234,78.0141844,12.23404255,9.75177305,972200
345,92675,269,222,491,137,96,724,37.15469613,30.66298343,67.81767956,18.92265193,13.25966851,770000
346,92683,443,249,692,116,87,895,49.4972067,27.82122905,77.31843575,12.96089385,9.720670391,651200
347,92688,255,137,392,64,42,498,51.20481928,27.51004016,78.71485944,12.85140562,8.43373494,673400
348,92691,362,266,628,141,109,878,41.23006834,30.29612756,71.5261959,16.05922551,12.41457859,750800
349,92692,195,131,326,72,62,460,42.39130435,28.47826087,70.86956522,15.65217391,13.47826087,795500
350,92701,570,473,1043,307,359,1709,33.35283792,27.6770041,61.02984201,17.96372147,21.00643651,521700
351,92703,8,69,77,123,319,519,1.541425819,13.29479769,14.83622351,23.69942197,61.46435453,486000
352,92704,411,678,1089,606,714,2409,17.06102117,28.14445828,45.20547945,25.15566625,29.6388543,534800
353,92705,210,180,390,128,161,679,30.92783505,26.5095729,57.43740795,18.85125184,23.71134021,914900
354,92706,95,138,233,63,41,337,28.18991098,40.9495549,69.13946588,18.69436202,12.16617211,673300
355,92707,42,87,129,155,282,566,7.4204947,15.37102473,22.79151943,27.38515901,49.82332155,539700
356,92708,504,279,783,94,60,937,53.7886873,29.77588047,83.56456777,10.03201708,6.403415155,816900
357,92780,140,175,315,146,167,628,22.29299363,27.86624204,50.15923567,23.24840764,26.59235669,669400
358,92801,109,295,404,309,382,1095,9.9543379,26.94063927,36.89497717,28.21917808,34.88584475,543200
359,92802,49,186,235,223,293,751,6.524633822,24.76697736,31.29161119,29.69374168,39.01464714,577500
360,92804,574,1081,1655,939,1051,3645,15.74759945,29.65706447,45.40466392,25.76131687,28.8340192,594400
361,92805,106,421,527,455,597,1579,6.713109563,26.66244459,33.37555415,28.81570614,37.80873971,583800
362,92806,141,484,625,514,585,1724,8.178654292,28.07424594,36.25290023,29.81438515,33.93271462,623300
363,92807,313,228,541,156,128,825,37.93939394,27.63636364,65.57575758,18.90909091,15.51515152,731100
364,92808,322,425,747,192,123,1062,30.32015066,40.01883239,70.33898305,18.07909605,11.5819209,807100
365,92821,343,488,831,266,171,1268,27.05047319,38.48580442,65.5362776,20.97791798,13.48580442,700900
366,92831,394,145,539,95,103,737,53.45997286,19.6743555,73.13432836,12.89009498,13.97557666,676300
367,92832,143,140,283,81,49,413,34.62469734,33.89830508,68.52300242,19.6125908,11.86440678,615300
368,92833,272,158,430,85,64,579,46.9775475,27.28842832,74.26597582,14.68048359,11.05354059,686700
369,92840,239,137,376,80,52,508,47.04724409,26.96850394,74.01574803,15.7480315,10.23622047,590900
370,92841,119,154,273,123,114,510,23.33333333,30.19607843,53.52941176,24.11764706,22.35294118,609900
371,92843,84,131,215,98,73,386,21.76165803,33.93782383,55.69948187,25.38860104,18.9119171,570200
372,92844,180,152,332,66,62,460,39.13043478,33.04347826,72.17391304,14.34782609,13.47826087,545400
373,92845,145,108,253,43,17,313,46.32587859,34.50479233,80.83067093,13.73801917,5.431309904,668900
374,92861,157,153,310,124,95,529,29.67863894,28.92249527,58.60113422,23.44045369,17.9584121,1287100
375,92867,65,145,210,150,190,550,11.81818182,26.36363636,38.18181818,27.27272727,34.54545455,780900
376,92869,180,153,333,97,92,522,34.48275862,29.31034483,63.79310345,18.58237548,17.62452107,770700
377,92870,412,332,744,182,105,1031,39.96120272,32.20174588,72.16294859,17.65276431,10.1842871,696700
378,92880,5,8,13,8,2,23,21.73913043,34.7826087,56.52173913,34.7826087,8.695652174,601700
379,92883,19,16,35,15,9,59,32.20338983,27.11864407,59.3220339,25.42372881,15.25423729,538500
380,92886,158,154,312,76,55,443,35.66591422,34.76297968,70.42889391,17.15575621,12.41534989,864700
381,93001,297,449,746,355,601,1702,17.45005875,26.38072855,43.83078731,20.85781434,35.31139835,630400
382,93003,659,876,1535,708,819,3062,21.52188112,28.60875245,50.13063357,23.12214239,26.74722404,617700
383,93004,171,195,366,182,240,788,21.70050761,24.74619289,46.44670051,23.0964467,30.45685279,608100
384,93010,602,863,1465,674,672,2811,21.41586624,30.70081821,52.11668445,23.9772323,23.90608324,662300
385,93012,697,701,1398,431,396,2225,31.3258427,31.50561798,62.83146067,19.37078652,17.79775281,657700
386,93013,108,242,350,212,246,808,13.36633663,29.95049505,43.31683168,26.23762376,30.44554455,822400
387,93021,784,854,1638,604,565,2807,27.93017456,30.42394015,58.35411471,21.51763449,20.1282508,690900
388,93022,32,70,102,37,47,186,17.20430108,37.6344086,54.83870968,19.89247312,25.2688172,610500
389,93023,82,134,216,116,135,467,17.55888651,28.69379015,46.25267666,24.83940043,28.90792291,692700
390,93030,123,239,362,248,285,895,13.74301676,26.70391061,40.44692737,27.70949721,31.84357542,530000
391,93033,149,284,433,245,210,888,16.77927928,31.98198198,48.76126126,27.59009009,23.64864865,442700
392,93036,414,963,1377,1044,1574,3995,10.36295369,24.10513141,34.46808511,26.13266583,39.39924906,527700
393,93060,46,148,194,111,166,471,9.766454352,31.42250531,41.18895966,23.56687898,35.24416136,446700
394,93063,517,733,1250,609,567,2426,21.31079967,30.2143446,51.52514427,25.10305029,23.37180544,626900
395,93065,2472,3437,5909,2858,3643,12410,19.91941982,27.69540693,47.61482675,23.02981467,29.35535858,642900
396,93066,16,38,54,31,31,116,13.79310345,32.75862069,46.55172414,26.72413793,26.72413793,1068500
397,93067,3,6,9,7,2,18,16.66666667,33.33333333,50,38.88888889,11.11111111,1875000
398,93103,11,12,23,33,49,105,10.47619048,11.42857143,21.9047619,31.42857143,46.66666667,1117000
399,93108,207,78,285,37,3,325,63.69230769,24,87.69230769,11.38461538,0.923076923,2000000
400,93117,3,7,10,3,2,15,20,46.66666667,66.66666667,20,13.33333333,838300
401,93202,41,118,159,154,251,564,7.269503546,20.92198582,28.19148936,27.30496454,44.5035461,187500
402,93203,83,117,200,158,229,587,14.13969336,19.9318569,34.07155026,26.9165247,39.01192504,192800
403,93204,36,132,168,190,660,1018,3.536345776,12.96660118,16.50294695,18.66404715,64.83300589,180200
404,93210,22,59,81,66,50,197,11.16751269,29.94923858,41.11675127,33.50253807,25.38071066,203100
405,93212,122,376,498,371,769,1638,7.448107448,22.95482295,30.4029304,22.64957265,46.94749695,176400
406,93215,371,556,927,471,476,1874,19.79722519,29.66915688,49.46638207,25.13340448,25.40021345,215100
407,93219,20,108,128,139,330,597,3.350083752,18.09045226,21.44053601,23.28308208,55.27638191,162500
408,93223,71,196,267,305,665,1237,5.739692805,15.84478577,21.58447858,24.65642684,53.75909458,189100
409,93224,6,21,27,12,18,57,10.52631579,36.84210526,47.36842105,21.05263158,31.57894737,152200
410,93230,750,1231,1981,1053,1343,4377,17.13502399,28.12428604,45.25931003,24.05757368,30.68311629,252300
411,93235,22,59,81,94,155,330,6.666666667,17.87878788,24.54545455,28.48484848,46.96969697,175600
412,93242,15,40,55,66,206,327,4.587155963,12.2324159,16.81957187,20.18348624,62.9969419,264100
413,93243,35,76,111,71,63,245,14.28571429,31.02040816,45.30612245,28.97959184,25.71428571,359400
414,93244,32,52,84,54,76,214,14.95327103,24.29906542,39.25233645,25.23364486,35.51401869,177800
415,93245,612,957,1569,669,712,2950,20.74576271,32.44067797,53.18644068,22.6779661,24.13559322,261400
416,93247,12,8,20,3,0,23,52.17391304,34.7826087,86.95652174,13.04347826,0,208800
417,93249,26,78,104,124,192,420,6.19047619,18.57142857,24.76190476,29.52380952,45.71428571,149100
418,93250,116,348,464,435,873,1772,6.546275395,19.63882619,26.18510158,24.54853273,49.26636569,203700
419,93252,964,1556,2520,1317,1469,5306,18.16811157,29.32529212,47.49340369,24.82095741,27.6856389,151100
420,93254,6,16,22,25,40,87,6.896551724,18.3908046,25.28735632,28.73563218,45.97701149,182200
421,93256,29,100,129,168,276,573,5.061082024,17.45200698,22.51308901,29.31937173,48.16753927,162700
422,93257,251,522,773,526,733,2032,12.3523622,25.68897638,38.04133858,25.88582677,36.07283465,211800
423,93261,5,33,38,81,233,352,1.420454545,9.375,10.79545455,23.01136364,66.19318182,127600
424,93263,172,491,663,550,1129,2342,7.344150299,20.96498719,28.30913749,23.48420154,48.20666097,206700
425,93265,28,54,82,46,50,178,15.73033708,30.33707865,46.06741573,25.84269663,28.08988764,305900
426,93267,108,164,272,221,398,891,12.12121212,18.40628507,30.52749719,24.80359147,44.66891134,143000
427,93268,24,65,89,64,47,200,12,32.5,44.5,32,23.5,164200
428,93270,43,104,147,126,288,561,7.664884135,18.53832442,26.20320856,22.45989305,51.3368984,221700
429,93271,17,26,43,22,17,82,20.73170732,31.70731707,52.43902439,26.82926829,20.73170732,333600
430,93274,662,1686,2348,1975,2947,7270,9.105914718,23.1911967,32.29711142,27.16643741,40.53645117,246600
431,93277,85,107,192,87,123,402,21.14427861,26.61691542,47.76119403,21.64179104,30.59701493,256600
432,93280,82,214,296,199,211,706,11.61473088,30.31161473,41.92634561,28.18696884,29.88668555,188300
433,93286,62,147,209,195,397,801,7.740324594,18.35205993,26.09238452,24.34456929,49.56304619,232800
434,93287,0,6,6,5,2,13,0,46.15384615,46.15384615,38.46153846,15.38461538,221900
435,93291,101,126,227,83,126,436,23.16513761,28.89908257,52.06422018,19.03669725,28.89908257,294800
436,93292,48,85,133,130,224,487,9.856262834,17.45379877,27.3100616,26.69404517,45.99589322,252500
437,93301,18,23,41,52,175,268,6.71641791,8.582089552,15.29850746,19.40298507,65.29850746,190600
438,93304,13,8,21,3,0,24,54.16666667,33.33333333,87.5,12.5,0,179300
439,93306,41,59,100,17,4,121,33.88429752,48.76033058,82.6446281,14.04958678,3.305785124,227700
440,93307,21,35,56,16,3,75,28,46.66666667,74.66666667,21.33333333,4,187100
441,93308,27,78,105,147,335,587,4.599659284,13.2879046,17.88756388,25.04258944,57.06984668,242800
442,93309,9,7,16,1,0,17,52.94117647,41.17647059,94.11764706,5.882352941,0,226200
443,93311,44,155,199,147,161,507,8.678500986,30.57199211,39.2504931,28.99408284,31.75542406,324800
444,93312,53,15,68,3,0,71,74.64788732,21.12676056,95.77464789,4.225352113,0,328400
445,93313,81,127,208,124,202,534,15.16853933,23.78277154,38.95131086,23.22097378,37.82771536,283400
446,93314,155,191,346,160,152,658,23.556231,29.02735562,52.58358663,24.31610942,23.10030395,412200
447,93401,221,227,448,163,139,750,29.46666667,30.26666667,59.73333333,21.73333333,18.53333333,775100
448,93402,180,242,422,184,134,740,24.32432432,32.7027027,57.02702703,24.86486486,18.10810811,616100
449,93405,521,470,991,323,342,1656,31.46135266,28.38164251,59.84299517,19.50483092,20.65217391,753500
450,93426,3,2,5,3,5,13,23.07692308,15.38461538,38.46153846,23.07692308,38.46153846,446200
451,93428,22,71,93,80,100,273,8.058608059,26.00732601,34.06593407,29.3040293,36.63003663,705200
452,93430,29,31,60,26,18,104,27.88461538,29.80769231,57.69230769,25,17.30769231,896700
453,93434,28,125,153,185,468,806,3.473945409,15.50868486,18.98263027,22.9528536,58.06451613,337100
454,93436,14,3,17,1,1,19,73.68421053,15.78947368,89.47368421,5.263157895,5.263157895,373600
455,93441,28,40,68,20,9,97,28.86597938,41.2371134,70.10309278,20.6185567,9.278350515,927500
456,93442,65,95,160,85,58,303,21.45214521,31.35313531,52.80528053,28.05280528,19.14191419,711900
457,93446,108,151,259,130,86,475,22.73684211,31.78947368,54.52631579,27.36842105,18.10526316,502500
458,93451,49,65,114,46,64,224,21.875,29.01785714,50.89285714,20.53571429,28.57142857,427400
459,93455,52,49,101,18,4,123,42.27642276,39.83739837,82.11382114,14.63414634,3.25203252,452600
460,93460,34,86,120,46,45,211,16.11374408,40.75829384,56.87203791,21.80094787,21.32701422,962500
461,93463,98,117,215,72,54,341,28.73900293,34.31085044,63.04985337,21.1143695,15.83577713,892900
462,93465,62,72,134,36,19,189,32.8042328,38.0952381,70.8994709,19.04761905,10.05291005,763200
463,93510,18,28,46,28,34,108,16.66666667,25.92592593,42.59259259,25.92592593,31.48148148,589000
464,93513,6,12,18,21,43,82,7.317073171,14.63414634,21.95121951,25.6097561,52.43902439,269600
465,93514,117,232,349,267,334,950,12.31578947,24.42105263,36.73684211,28.10526316,35.15789474,337700
466,93516,6,28,34,51,113,198,3.03030303,14.14141414,17.17171717,25.75757576,57.07070707,74500
467,93517,11,9,20,8,3,31,35.48387097,29.03225806,64.51612903,25.80645161,9.677419355,254200
468,93518,0,6,6,7,12,25,0,24,24,28,48,235800
469,93523,92,168,260,155,133,548,16.78832117,30.65693431,47.44525547,28.28467153,24.27007299,81200
470,93527,10,19,29,26,52,107,9.345794393,17.75700935,27.10280374,24.29906542,48.59813084,212100
471,93532,18,28,46,24,20,90,20,31.11111111,51.11111111,26.66666667,22.22222222,318700
472,93534,22,59,81,78,82,241,9.128630705,24.4813278,33.60995851,32.36514523,34.02489627,257600
473,93535,42,132,174,187,224,585,7.179487179,22.56410256,29.74358974,31.96581197,38.29059829,241800
474,93541,17,27,44,16,9,69,24.63768116,39.13043478,63.76811594,23.1884058,13.04347826,216300
475,93545,24,45,69,58,38,165,14.54545455,27.27272727,41.81818182,35.15151515,23.03030303,197600
476,93546,19,29,48,14,6,68,27.94117647,42.64705882,70.58823529,20.58823529,8.823529412,493800
477,93550,29,115,144,145,166,455,6.373626374,25.27472527,31.64835165,31.86813187,36.48351648,280900
478,93555,357,594,951,576,867,2394,14.9122807,24.81203008,39.72431078,24.06015038,36.21553885,194600
479,93561,191,373,564,357,499,1420,13.45070423,26.26760563,39.71830986,25.14084507,35.14084507,295000
480,93562,3,26,29,27,63,119,2.521008403,21.8487395,24.3697479,22.68907563,52.94117647,57600
481,93601,16,47,63,61,42,166,9.638554217,28.31325301,37.95180723,36.74698795,25.30120482,327800
482,93602,15,19,34,13,9,56,26.78571429,33.92857143,60.71428571,23.21428571,16.07142857,291300
483,93608,2,18,20,31,60,111,1.801801802,16.21621622,18.01801802,27.92792793,54.05405405,154600
484,93609,79,165,244,210,342,796,9.924623116,20.72864322,30.65326633,26.38190955,42.96482412,206000
485,93610,59,132,191,109,108,408,14.46078431,32.35294118,46.81372549,26.71568627,26.47058824,250600
486,93614,41,71,112,108,141,361,11.35734072,19.66759003,31.02493075,29.91689751,39.05817175,307300
487,93615,23,64,87,70,161,318,7.232704403,20.12578616,27.35849057,22.01257862,50.62893082,171900
488,93618,136,233,369,232,216,817,16.64626683,28.51897185,45.16523868,28.39657283,26.43818849,237000
489,93620,69,194,263,258,487,1008,6.845238095,19.24603175,26.09126984,25.5952381,48.31349206,267700
490,93622,117,334,451,300,437,1188,9.848484848,28.11447811,37.96296296,25.25252525,36.78451178,185900
491,93625,180,352,532,322,377,1231,14.62225833,28.59463851,43.21689683,26.15759545,30.62550772,298100
492,93630,276,775,1051,821,781,2653,10.403317,29.21221259,39.61552959,30.94609876,29.43837165,262200
493,93631,429,624,1053,518,524,2095,20.47732697,29.78520286,50.26252983,24.72553699,25.01193317,326800
494,93635,7,38,45,78,160,283,2.473498233,13.42756184,15.90106007,27.56183746,56.53710247,343000
495,93636,225,348,573,255,216,1044,21.55172414,33.33333333,54.88505747,24.42528736,20.68965517,375000
496,93637,0,1,1,2,11,14,0,7.142857143,7.142857143,14.28571429,78.57142857,275900
497,93638,33,47,80,47,52,179,18.43575419,26.25698324,44.69273743,26.25698324,29.05027933,239700
498,93640,146,313,459,376,967,1802,8.102108768,17.36958935,25.47169811,20.86570477,53.66259711,204600
499,93644,61,112,173,94,133,400,15.25,28,43.25,23.5,33.25,301300
500,93646,154,313,467,359,495,1321,11.65783497,23.69417108,35.35200606,27.17638153,37.47161241,201700
501,93647,178,392,570,388,734,1692,10.52009456,23.1678487,33.68794326,22.93144208,43.38061466,167400
502,93648,133,316,449,422,980,1851,7.18530524,17.07185305,24.25715829,22.7984873,52.9443544,186100
503,93651,56,76,132,80,59,271,20.66420664,28.04428044,48.70848708,29.5202952,21.77121771,366400
504,93652,5,18,23,39,123,185,2.702702703,9.72972973,12.43243243,21.08108108,66.48648649,169900
505,93653,4,16,20,13,10,43,9.302325581,37.20930233,46.51162791,30.23255814,23.25581395,443500
506,93654,498,886,1384,795,904,3083,16.15309763,28.73824197,44.8913396,25.78657152,29.32208887,250200
507,93656,59,213,272,219,267,758,7.783641161,28.10026385,35.88390501,28.89182058,35.22427441,208200
508,93657,160,246,406,139,86,631,25.35657686,38.98573693,64.34231379,22.02852615,13.62916006,307100
509,93660,8,41,49,80,250,379,2.110817942,10.81794195,12.92875989,21.10817942,65.96306069,207900
510,93662,83,119,202,81,37,320,25.9375,37.1875,63.125,25.3125,11.5625,216900
511,93667,57,100,157,67,59,283,20.14134276,35.33568905,55.4770318,23.67491166,20.84805654,283300
512,93668,12,32,44,48,99,191,6.282722513,16.7539267,23.03664921,25.13089005,51.83246073,370600
513,93673,7,29,36,34,61,131,5.34351145,22.13740458,27.48091603,25.95419847,46.5648855,176100
514,93701,4,6,10,8,21,39,10.25641026,15.38461538,25.64102564,20.51282051,53.84615385,164100
515,93702,39,101,140,92,109,341,11.43695015,29.61876833,41.05571848,26.97947214,31.96480938,159800
516,93703,54,113,167,118,169,454,11.89427313,24.88986784,36.78414097,25.99118943,37.2246696,183200
517,93704,120,242,362,215,254,831,14.44043321,29.12154031,43.56197353,25.87244284,30.56558363,291600
518,93705,18,51,69,57,90,216,8.333333333,23.61111111,31.94444444,26.38888889,41.66666667,213400
519,93706,382,721,1103,876,1482,3461,11.03727246,20.83212944,31.86940191,25.31060387,42.81999422,186300
520,93710,36,67,103,83,75,261,13.79310345,25.67049808,39.46360153,31.80076628,28.73563218,281800
521,93721,17,52,69,48,154,271,6.273062731,19.18819188,25.46125461,17.71217712,56.82656827,181500
522,93722,94,185,279,194,217,690,13.62318841,26.8115942,40.43478261,28.11594203,31.44927536,270900
523,93725,16,28,44,39,62,145,11.03448276,19.31034483,30.34482759,26.89655172,42.75862069,226200
524,93726,86,220,306,224,205,735,11.70068027,29.93197279,41.63265306,30.47619048,27.89115646,214600
525,93727,60,171,231,162,155,548,10.94890511,31.20437956,42.15328467,29.5620438,28.28467153,287000
526,93907,4,17,21,34,45,100,4,17,21,34,45,566800
527,93908,58,140,198,80,31,309,18.77022654,45.30744337,64.0776699,25.88996764,10.03236246,846200
528,93920,8,4,12,5,3,20,40,20,60,25,15,1081500
529,93923,168,97,265,53,31,349,48.13753582,27.79369628,75.93123209,15.18624642,8.88252149,1199000
530,93924,94,72,166,36,26,228,41.22807018,31.57894737,72.80701754,15.78947368,11.40350877,987100
531,93926,54,103,157,99,271,527,10.24667932,19.54459203,29.79127135,18.78557875,51.42314991,453700
532,93927,47,69,116,68,89,273,17.21611722,25.27472527,42.49084249,24.90842491,32.6007326,350400
533,93930,63,106,169,82,34,285,22.10526316,37.19298246,59.29824561,28.77192982,11.92982456,336200
534,93940,40,81,121,73,77,271,14.7601476,29.88929889,44.64944649,26.93726937,28.41328413,861000
535,93950,58,84,142,62,42,246,23.57723577,34.14634146,57.72357724,25.20325203,17.07317073,929200
536,93954,3,10,13,11,19,43,6.976744186,23.25581395,30.23255814,25.58139535,44.18604651,230800
537,93955,50,104,154,81,47,282,17.73049645,36.87943262,54.60992908,28.72340426,16.66666667,588100
538,93962,51,78,129,89,77,295,17.28813559,26.44067797,43.72881356,30.16949153,26.10169492,562500
539,94002,1016,612,1628,243,138,2009,50.57242409,30.46291687,81.03534097,12.09556994,6.869089099,1678500
540,94005,61,70,131,46,31,208,29.32692308,33.65384615,62.98076923,22.11538462,14.90384615,923800
541,94010,1377,896,2273,409,299,2981,46.19255283,30.05702784,76.24958068,13.72022811,10.03019121,2000000
542,94014,167,319,486,278,366,1130,14.77876106,28.2300885,43.00884956,24.60176991,32.38938053,865400
543,94015,437,610,1047,500,566,2113,20.6814955,28.86890677,49.55040227,23.66303833,26.78655939,932200
544,94022,665,260,925,88,42,1055,63.03317536,24.64454976,87.67772512,8.341232227,3.981042654,2000000
545,94024,95,55,150,25,18,193,49.22279793,28.49740933,77.72020725,12.95336788,9.32642487,2000000
546,94025,342,215,557,137,220,914,37.41794311,23.52297593,60.94091904,14.98905908,24.07002188,2000000
547,94027,59,22,81,13,4,98,60.20408163,22.44897959,82.65306122,13.26530612,4.081632653,2000000
548,94028,169,79,248,42,17,307,55.04885993,25.73289902,80.78175896,13.68078176,5.537459283,2000000
549,94030,389,415,804,188,183,1175,33.10638298,35.31914894,68.42553191,16,15.57446809,1606700
550,94040,195,47,242,20,10,272,71.69117647,17.27941176,88.97058824,7.352941176,3.676470588,2000000
551,94044,325,508,833,333,313,1479,21.97430696,34.34753212,56.32183908,22.51521298,21.16294794,1012200
552,94062,124,75,199,34,6,239,51.88284519,31.38075314,83.26359833,14.22594142,2.510460251,2000000
553,94063,67,134,201,168,278,647,10.35548686,20.71097372,31.06646059,25.96599691,42.9675425,1002400
554,94065,303,149,452,78,54,584,51.88356164,25.51369863,77.39726027,13.35616438,9.246575342,1545800
555,94066,312,444,756,369,512,1637,19.05925473,27.12278558,46.18204032,22.54123396,31.27672572,1027400
556,94070,885,668,1553,288,157,1998,44.29429429,33.43343343,77.72772773,14.41441441,7.857857858,1910300
557,94080,533,751,1284,689,913,2886,18.46846847,26.02217602,44.49064449,23.87387387,31.63548164,963700
558,94087,924,610,1534,300,201,2035,45.40540541,29.97542998,75.38083538,14.74201474,9.877149877,1945100
559,94110,53,90,143,71,43,257,20.62256809,35.01945525,55.64202335,27.62645914,16.73151751,1233600
560,94112,12,18,30,11,9,50,24,36,60,22,18,1022100
561,94115,74,103,177,127,159,463,15.98272138,22.2462203,38.22894168,27.42980562,34.3412527,1515600
562,94121,11,3,14,1,3,18,61.11111111,16.66666667,77.77777778,5.555555556,16.66666667,1506400
563,94124,36,67,103,75,161,339,10.61946903,19.7640118,30.38348083,22.12389381,47.49262537,873900
564,94127,6,8,14,5,3,22,27.27272727,36.36363636,63.63636364,22.72727273,13.63636364,1572100
565,94301,260,113,373,47,41,461,56.39913232,24.51193059,80.91106291,10.19522777,8.893709328,2000000
566,94303,684,437,1121,197,142,1460,46.84931507,29.93150685,76.78082192,13.49315068,9.726027397,1567000
567,94305,223,97,320,50,29,399,55.88972431,24.31077694,80.20050125,12.53132832,7.268170426,2000000
568,94306,1327,694,2021,242,170,2433,54.54171804,28.5244554,83.06617345,9.946568023,6.987258529,2000000
569,94401,230,126,356,87,146,589,39.04923599,21.39219015,60.44142615,14.77079796,24.78777589,944300
570,94402,509,544,1053,346,527,1926,26.4278297,28.2450675,54.6728972,17.96469367,27.36240914,1882300
571,94403,455,562,1017,436,769,2222,20.4770477,25.29252925,45.76957696,19.6219622,34.60846085,1499300
572,94404,906,553,1459,237,175,1871,48.42330305,29.55638696,77.97969001,12.66702298,9.353287012,1404600
573,94503,89,173,262,115,101,478,18.61924686,36.19246862,54.81171548,24.05857741,21.12970711,557800
574,94508,2,5,7,4,5,16,12.5,31.25,43.75,25,31.25,684400
575,94509,50,103,153,90,86,329,15.19756839,31.30699088,46.50455927,27.3556231,26.13981763,435600
576,94510,8,5,13,0,0,13,61.53846154,38.46153846,100,0,0,628300
577,94514,2,5,7,2,4,13,15.38461538,38.46153846,53.84615385,15.38461538,30.76923077,711000
578,94516,7,7,14,6,5,25,28,28,56,24,20,685500
579,94517,226,279,505,165,116,786,28.75318066,35.49618321,64.24936387,20.99236641,14.75826972,815600
580,94518,71,192,263,304,602,1169,6.073567151,16.42429427,22.49786142,26.00513259,51.49700599,649100
581,94519,97,116,213,138,225,576,16.84027778,20.13888889,36.97916667,23.95833333,39.0625,608400
582,94520,54,122,176,171,514,861,6.271777003,14.16957027,20.44134727,19.86062718,59.69802555,480300
583,94521,308,534,842,549,686,2077,14.8290804,25.71015888,40.53923929,26.43235436,33.02840636,649100
584,94523,727,880,1607,631,669,2907,25.00859993,30.27175783,55.28035776,21.70622635,23.01341589,827200
585,94526,6,6,12,3,0,15,40,40,80,20,0,1265000
586,94531,99,108,207,69,61,337,29.3768546,32.04747774,61.42433234,20.47477745,18.10089021,528200
587,94533,165,230,395,224,254,873,18.90034364,26.34593356,45.24627721,25.65864834,29.09507446,393700
588,94534,158,159,317,76,63,456,34.64912281,34.86842105,69.51754386,16.66666667,13.81578947,589000
589,94536,632,210,842,92,80,1014,62.32741617,20.71005917,83.03747535,9.072978304,7.889546351,989600
590,94538,466,193,659,101,71,831,56.07701564,23.22503008,79.30204573,12.15403129,8.543922984,888400
591,94539,406,66,472,20,12,504,80.55555556,13.0952381,93.65079365,3.968253968,2.380952381,1548800
592,94541,30,69,99,89,163,351,8.547008547,19.65811966,28.20512821,25.35612536,46.43874644,641200
593,94544,0,2,2,4,7,13,0,15.38461538,15.38461538,30.76923077,53.84615385,624800
594,94545,105,205,310,138,119,567,18.51851852,36.15520282,54.67372134,24.33862434,20.98765432,664400
595,94546,1001,797,1798,417,380,2595,38.57418112,30.71290944,69.28709056,16.06936416,14.64354528,811300
596,94549,1100,753,1853,297,138,2288,48.07692308,32.91083916,80.98776224,12.98076923,6.031468531,1547800
597,94550,1149,1155,2304,633,538,3475,33.0647482,33.23741007,66.30215827,18.21582734,15.48201439,925400
598,94551,541,705,1246,458,575,2279,23.73848179,30.93462045,54.67310224,20.09653357,25.23036419,774200
599,94552,521,584,1105,303,204,1612,32.32009926,36.22828784,68.5483871,18.79652605,12.65508685,1056100
600,94553,136,167,303,114,154,571,23.8178634,29.2469352,53.0647986,19.96497373,26.97022767,628400
601,94556,208,62,270,22,8,300,69.33333333,20.66666667,90,7.333333333,2.666666667,1224100
602,94563,122,55,177,18,13,208,58.65384615,26.44230769,85.09615385,8.653846154,6.25,1539900
603,94565,95,218,313,323,821,1457,6.520247083,14.9622512,21.48249828,22.16884008,56.34866163,442300
604,94567,1,5,6,11,15,32,3.125,15.625,18.75,34.375,46.875,383300
605,94574,51,35,86,12,6,104,49.03846154,33.65384615,82.69230769,11.53846154,5.769230769,1295900
606,94580,167,174,341,114,100,555,30.09009009,31.35135135,61.44144144,20.54054054,18.01801802,649600
607,94582,30,5,35,1,0,36,83.33333333,13.88888889,97.22222222,2.777777778,0,1153600
608,94583,19,5,24,0,0,24,79.16666667,20.83333333,100,0,0,987300
609,94587,274,220,494,123,91,708,38.70056497,31.07344633,69.7740113,17.37288136,12.85310734,860300
610,94589,45,151,196,108,195,499,9.018036072,30.26052104,39.27855711,21.64328657,39.07815631,372000
611,94590,1,12,13,9,7,29,3.448275862,41.37931034,44.82758621,31.03448276,24.13793103,381400
612,94591,31,45,76,42,32,150,20.66666667,30,50.66666667,28,21.33333333,482700
613,94596,174,98,272,42,15,329,52.88753799,29.78723404,82.67477204,12.76595745,4.559270517,1081800
614,94598,667,601,1268,298,215,1781,37.4508703,33.74508703,71.19595733,16.73217294,12.07186974,1050800
615,94601,81,136,217,92,103,412,19.66019417,33.00970874,52.66990291,22.33009709,25,581800
616,94603,31,76,107,82,242,431,7.192575406,17.63341067,24.82598608,19.02552204,56.14849188,447000
617,94605,129,208,337,170,151,658,19.60486322,31.61094225,51.21580547,25.83586626,22.94832827,695000
618,94607,230,301,531,237,322,1090,21.10091743,27.6146789,48.71559633,21.74311927,29.5412844,640800
619,94608,184,79,263,40,22,325,56.61538462,24.30769231,80.92307692,12.30769231,6.769230769,691300
620,94610,5,13,18,17,14,49,10.20408163,26.53061224,36.73469388,34.69387755,28.57142857,1125700
621,94611,620,370,990,120,45,1155,53.67965368,32.03463203,85.71428571,10.38961039,3.896103896,1199600
622,94612,10,39,49,24,33,106,9.433962264,36.79245283,46.22641509,22.64150943,31.13207547,848500
623,94621,41,171,212,207,378,797,5.144291092,21.45545797,26.59974906,25.97239649,47.42785445,445600
624,94704,52,19,71,1,2,74,70.27027027,25.67567568,95.94594595,1.351351351,2.702702703,787300
625,94706,152,45,197,13,6,216,70.37037037,20.83333333,91.2037037,6.018518519,2.777777778,964500
626,94801,14,46,60,35,35,130,10.76923077,35.38461538,46.15384615,26.92307692,26.92307692,475100
627,94804,6,23,29,15,25,69,8.695652174,33.33333333,42.02898551,21.73913043,36.23188406,526600
628,94806,125,254,379,225,273,877,14.25313569,28.96237172,43.21550741,25.65564424,31.12884835,479200
629,94901,407,606,1013,566,989,2568,15.84890966,23.59813084,39.4470405,22.04049844,38.51246106,1136000
630,94903,102,178,280,159,215,654,15.59633028,27.21712538,42.81345566,24.31192661,32.87461774,940800
631,94920,357,281,638,103,54,795,44.90566038,35.34591195,80.25157233,12.95597484,6.79245283,2000000
632,94924,12,19,31,11,5,47,25.53191489,40.42553191,65.95744681,23.40425532,10.63829787,1119300
633,94925,261,120,381,44,36,461,56.61605206,26.03036876,82.64642082,9.544468547,7.809110629,1372500
634,94928,107,131,238,70,31,339,31.56342183,38.64306785,70.20648968,20.64896755,9.144542773,546100
635,94930,272,293,565,150,95,810,33.58024691,36.17283951,69.75308642,18.51851852,11.72839506,927100
636,94939,444,309,753,126,78,957,46.39498433,32.28840125,78.68338558,13.1661442,8.150470219,1697200
637,94941,135,108,243,47,29,319,42.31974922,33.85579937,76.17554859,14.73354232,9.090909091,1582800
638,94945,216,225,441,150,181,772,27.97927461,29.14507772,57.12435233,19.43005181,23.44559585,909300
639,94946,5,5,10,6,8,24,20.83333333,20.83333333,41.66666667,25,33.33333333,1736600
640,94947,389,520,909,380,388,1677,23.19618366,31.00775194,54.2039356,22.65951103,23.13655337,851100
641,94949,196,350,546,333,381,1260,15.55555556,27.77777778,43.33333333,26.42857143,30.23809524,829100
642,94952,349,411,760,252,215,1227,28.44335778,33.49633252,61.9396903,20.53789731,17.52241239,866200
643,94954,367,518,885,339,274,1498,24.49933244,34.57943925,59.0787717,22.63017356,18.29105474,661700
644,94956,18,21,39,25,23,87,20.68965517,24.13793103,44.82758621,28.73563218,26.43678161,1299500
645,94960,320,202,522,106,63,691,46.30969609,29.23299566,75.54269175,15.34008683,9.117221418,1308500
646,94963,22,43,65,29,11,105,20.95238095,40.95238095,61.9047619,27.61904762,10.47619048,928600
647,94965,1,9,10,17,31,58,1.724137931,15.51724138,17.24137931,29.31034483,53.44827586,1173700
648,94971,9,37,46,27,36,109,8.256880734,33.94495413,42.20183486,24.7706422,33.02752294,845200
649,95004,35,54,89,43,72,204,17.15686275,26.47058824,43.62745098,21.07843137,35.29411765,780500
650,95006,98,88,186,51,25,262,37.40458015,33.58778626,70.99236641,19.46564885,9.541984733,646300
651,95008,149,89,238,37,31,306,48.69281046,29.08496732,77.77777778,12.09150327,10.13071895,1230900
652,95014,2920,1515,4435,465,318,5218,55.96013798,29.03411269,84.99425067,8.91146033,6.094289,2000000
653,95018,50,23,73,16,20,109,45.87155963,21.10091743,66.97247706,14.67889908,18.34862385,657200
654,95023,2,10,12,12,16,40,5,25,30,30,40,609800
655,95030,184,96,280,39,25,344,53.48837209,27.90697674,81.39534884,11.3372093,7.26744186,2000000
656,95032,539,471,1010,188,102,1300,41.46153846,36.23076923,77.69230769,14.46153846,7.846153846,1726700
657,95033,35,21,56,12,12,80,43.75,26.25,70,15,15,1160400
658,95035,274,147,421,77,65,563,48.6678508,26.11012433,74.77797513,13.67673179,11.54529307,995200
659,95037,193,149,342,49,36,427,45.19906323,34.89461358,80.09367681,11.47540984,8.430913349,954600
660,95045,31,59,90,62,117,269,11.52416357,21.9330855,33.45724907,23.04832714,43.49442379,726500
661,95051,404,299,703,177,151,1031,39.18525703,29.00096993,68.18622696,17.16779825,14.64597478,1253100
662,95054,18,12,30,2,2,34,52.94117647,35.29411765,88.23529412,5.882352941,5.882352941,1195700
663,95060,114,98,212,66,47,325,35.07692308,30.15384615,65.23076923,20.30769231,14.46153846,971100
664,95062,68,76,144,53,28,225,30.22222222,33.77777778,64,23.55555556,12.44444444,840100
665,95066,279,284,563,164,122,849,32.86219081,33.45111896,66.31330978,19.31684335,14.36984688,920600
666,95070,1027,584,1611,175,72,1858,55.2744887,31.43164693,86.70613563,9.418729817,3.875134553,2000000
667,95073,31,11,42,1,6,49,63.26530612,22.44897959,85.71428571,2.040816327,12.24489796,842800
668,95075,4,5,9,12,17,38,10.52631579,13.15789474,23.68421053,31.57894737,44.73684211,809000
669,95076,4,5,9,1,2,12,33.33333333,41.66666667,75,8.333333333,16.66666667,626100
670,95110,51,152,203,201,368,772,6.606217617,19.68911917,26.29533679,26.03626943,47.66839378,739600
671,95111,181,212,393,143,139,675,26.81481481,31.40740741,58.22222222,21.18518519,20.59259259,661700
672,95112,114,304,418,377,813,1608,7.089552239,18.90547264,25.99502488,23.44527363,50.55970149,823900
673,95116,66,195,261,194,335,790,8.35443038,24.6835443,33.03797468,24.55696203,42.40506329,687900
674,95117,109,131,240,102,71,413,26.39225182,31.71912833,58.11138015,24.69733656,17.19128329,1141000
675,95118,675,637,1312,380,415,2107,32.03607024,30.23255814,62.26862838,18.03512103,19.69625059,1111900
676,95120,1474,1020,2494,507,360,3361,43.85599524,30.34811068,74.20410592,15.08479619,10.71109789,1546400
677,95121,208,170,378,62,30,470,44.25531915,36.17021277,80.42553191,13.19148936,6.382978723,838900
678,95122,325,460,785,423,445,1653,19.66122202,27.82819117,47.48941319,25.58983666,26.92075015,674500
679,95123,276,279,555,188,192,935,29.51871658,29.83957219,59.35828877,20.10695187,20.53475936,889800
680,95124,204,83,287,35,24,346,58.95953757,23.98843931,82.94797688,10.11560694,6.936416185,1259000
681,95125,826,827,1653,626,817,3096,26.67958656,26.7118863,53.39147287,20.21963824,26.38888889,1300600
682,95126,201,403,604,373,553,1530,13.1372549,26.33986928,39.47712418,24.37908497,36.14379085,1011900
683,95127,93,133,226,100,63,389,23.90745501,34.19023136,58.09768638,25.70694087,16.19537275,806400
684,95128,55,79,134,53,45,232,23.70689655,34.05172414,57.75862069,22.84482759,19.39655172,1054000
685,95129,1377,619,1996,227,147,2370,58.10126582,26.11814346,84.21940928,9.578059072,6.202531646,1641700
686,95131,1,5,6,17,49,72,1.388888889,6.944444444,8.333333333,23.61111111,68.05555556,976300
687,95132,210,115,325,55,36,416,50.48076923,27.64423077,78.125,13.22115385,8.653846154,1072200
688,95133,124,128,252,84,126,462,26.83982684,27.70562771,54.54545455,18.18181818,27.27272727,869200
689,95136,43,62,105,84,157,346,12.42774566,17.91907514,30.34682081,24.27745665,45.37572254,897500
690,95148,334,148,482,66,34,582,57.38831615,25.42955326,82.81786942,11.34020619,5.841924399,998600
691,95202,121,174,295,226,411,932,12.98283262,18.6695279,31.65236052,24.24892704,44.09871245,265400
692,95203,30,89,119,51,26,196,15.30612245,45.40816327,60.71428571,26.02040816,13.26530612,268100
693,95205,21,46,67,55,121,243,8.641975309,18.93004115,27.57201646,22.63374486,49.79423868,225400
694,95206,138,346,484,424,608,1516,9.102902375,22.823219,31.92612137,27.96833773,40.1055409,291800
695,95207,478,827,1305,676,944,2925,16.34188034,28.27350427,44.61538462,23.11111111,32.27350427,318500
696,95209,488,749,1237,779,1144,3160,15.44303797,23.70253165,39.14556962,24.65189873,36.20253165,367400
697,95210,98,228,326,261,521,1108,8.844765343,20.57761733,29.42238267,23.55595668,47.02166065,259000
698,95212,194,373,567,417,657,1641,11.82205972,22.73004266,34.55210238,25.41133455,40.03656307,401500
699,95215,29,71,100,81,109,290,10,24.48275862,34.48275862,27.93103448,37.5862069,303500
700,95219,327,485,812,481,719,2012,16.25248509,24.10536779,40.35785288,23.90656064,35.73558648,436900
701,95220,59,139,198,152,131,481,12.26611227,28.8981289,41.16424116,31.6008316,27.23492723,642500
702,95223,19,15,34,16,16,66,28.78787879,22.72727273,51.51515152,24.24242424,24.24242424,360600
703,95224,32,60,92,38,43,173,18.49710983,34.68208092,53.17919075,21.96531792,24.85549133,327800
704,95230,7,5,12,11,24,47,14.89361702,10.63829787,25.53191489,23.40425532,51.06382979,591900
705,95237,29,76,105,64,113,282,10.28368794,26.95035461,37.23404255,22.69503546,40.07092199,372700
706,95240,208,443,651,562,1063,2276,9.13884007,19.46397188,28.60281195,24.69244288,46.70474517,352400
707,95242,567,993,1560,956,1188,3704,15.30777538,26.80885529,42.11663067,25.80993521,32.07343413,440100
708,95245,3,14,17,19,34,70,4.285714286,20,24.28571429,27.14285714,48.57142857,383800
709,95247,24,25,49,22,19,90,26.66666667,27.77777778,54.44444444,24.44444444,21.11111111,357500
710,95249,60,126,186,115,140,441,13.60544218,28.57142857,42.17687075,26.07709751,31.74603175,332300
711,95252,37,162,199,196,347,742,4.986522911,21.8328841,26.81940701,26.41509434,46.76549865,360200
712,95255,3,10,13,12,18,43,6.976744186,23.25581395,30.23255814,27.90697674,41.86046512,231500
713,95301,150,253,403,231,214,848,17.68867925,29.83490566,47.52358491,27.24056604,25.23584906,288800
714,95303,24,58,82,48,83,213,11.26760563,27.23004695,38.49765258,22.53521127,38.96713615,592600
715,95304,153,352,505,327,455,1287,11.88811189,27.35042735,39.23853924,25.40792541,35.35353535,692400
716,95307,112,194,306,185,165,656,17.07317073,29.57317073,46.64634146,28.20121951,25.15243902,313000
717,95310,25,53,78,82,96,256,9.765625,20.703125,30.46875,32.03125,37.5,379500
718,95311,2,6,8,10,20,38,5.263157895,15.78947368,21.05263158,26.31578947,52.63157895,252400
719,95313,14,52,66,63,68,197,7.106598985,26.39593909,33.50253807,31.97969543,34.5177665,494000
720,95315,86,239,325,285,535,1145,7.510917031,20.87336245,28.38427948,24.89082969,46.72489083,273000
721,95316,64,138,202,195,247,644,9.937888199,21.42857143,31.36645963,30.27950311,38.35403727,375000
722,95317,4,40,44,29,31,104,3.846153846,38.46153846,42.30769231,27.88461538,29.80769231,425000
723,95318,9,7,16,9,18,43,20.93023256,16.27906977,37.20930233,20.93023256,41.86046512,241500
724,95319,1,0,1,7,19,27,3.703703704,0,3.703703704,25.92592593,70.37037037,194700
725,95320,187,386,573,285,334,1192,15.68791946,32.38255034,48.0704698,23.90939597,28.02013423,448000
726,95321,2,33,35,35,55,125,1.6,26.4,28,28,44,330900
727,95323,133,188,321,143,84,548,24.27007299,34.30656934,58.57664234,26.09489051,15.32846715,451400
728,95324,33,48,81,33,32,146,22.60273973,32.87671233,55.47945205,22.60273973,21.91780822,313200
729,95326,14,57,71,66,87,224,6.25,25.44642857,31.69642857,29.46428571,38.83928571,366500
730,95327,12,33,45,51,89,185,6.486486486,17.83783784,24.32432432,27.56756757,48.10810811,271800
731,95328,55,118,173,83,150,406,13.54679803,29.06403941,42.61083744,20.44334975,36.94581281,306000
732,95329,10,26,36,28,46,110,9.090909091,23.63636364,32.72727273,25.45454545,41.81818182,284400
733,95330,388,524,912,332,287,1531,25.34291313,34.22599608,59.56890921,21.68517309,18.7459177,431400
734,95334,200,420,620,495,763,1878,10.64962726,22.36421725,33.01384452,26.35782748,40.62832801,246500
735,95336,154,334,488,276,240,1004,15.33864542,33.26693227,48.60557769,27.49003984,23.90438247,398100
736,95338,65,185,250,140,178,568,11.44366197,32.57042254,44.01408451,24.64788732,31.33802817,320800
737,95340,2,10,12,25,60,97,2.06185567,10.30927835,12.37113402,25.77319588,61.8556701,300400
738,95341,186,503,689,473,477,1639,11.34838316,30.68944478,42.03782794,28.8590604,29.10311165,232400
739,95348,151,246,397,199,204,800,18.875,30.75,49.625,24.875,25.5,273400
740,95350,333,721,1054,895,1612,3561,9.351305813,20.2471216,29.59842741,25.1333895,45.26818309,309800
741,95351,138,430,568,645,1664,2877,4.796663191,14.94612444,19.74278763,22.41918665,57.83802572,241800
742,95354,135,275,410,277,475,1162,11.61790017,23.66609294,35.28399312,23.83820998,40.8777969,280500
743,95355,445,473,918,369,441,1728,25.75231481,27.37268519,53.125,21.35416667,25.52083333,359200
744,95356,242,328,570,263,333,1166,20.75471698,28.13036021,48.88507719,22.55574614,28.55917667,389900
745,95357,42,65,107,49,58,214,19.62616822,30.37383178,50,22.89719626,27.10280374,340300
746,95358,292,548,840,680,1104,2624,11.12804878,20.88414634,32.01219512,25.91463415,42.07317073,319900
747,95360,50,60,110,37,25,172,29.06976744,34.88372093,63.95348837,21.51162791,14.53488372,298300
748,95361,407,663,1070,618,734,2422,16.80429397,27.37407102,44.17836499,25.51610239,30.30553262,407700
749,95363,75,98,173,66,44,283,26.50176678,34.62897527,61.13074205,23.32155477,15.54770318,360300
750,95365,26,102,128,148,195,471,5.520169851,21.65605096,27.17622081,31.42250531,41.40127389,183900
751,95366,440,564,1004,371,293,1668,26.37889688,33.81294964,60.19184652,22.24220624,17.56594724,522100
752,95367,109,273,382,283,520,1185,9.198312236,23.03797468,32.23628692,23.88185654,43.88185654,344800
753,95368,118,327,445,336,486,1267,9.313338595,25.80899763,35.12233623,26.51933702,38.35832676,349000
754,95369,14,15,29,13,8,50,28,30,58,26,16,339200
755,95370,215,372,587,317,325,1229,17.49389748,30.26851098,47.76240846,25.79332791,26.44426363,342700
756,95372,33,89,122,89,106,317,10.41009464,28.07570978,38.48580442,28.07570978,33.4384858,317000
757,95376,745,1445,2190,1573,2426,6189,12.03748586,23.34787526,35.38536112,25.41606075,39.19857812,454200
758,95377,466,636,1102,523,547,2172,21.45488029,29.28176796,50.73664825,24.07918969,25.18416206,594900
759,95379,87,100,187,89,75,351,24.78632479,28.49002849,53.27635328,25.35612536,21.36752137,319000
760,95380,332,621,953,720,1273,2946,11.26951799,21.07942974,32.34894773,24.43991853,43.21113374,319900
761,95382,607,976,1583,875,1217,3675,16.5170068,26.55782313,43.07482993,23.80952381,33.11564626,374600
762,95383,26,43,69,61,43,173,15.02890173,24.85549133,39.88439306,35.26011561,24.85549133,364200
763,95386,87,239,326,269,352,947,9.186906019,25.2375924,34.42449842,28.40549102,37.17001056,323200
764,95388,184,314,498,359,497,1354,13.58936484,23.19054653,36.77991137,26.5140325,36.70605613,231700
765,95389,10,5,15,0,1,16,62.5,31.25,93.75,0,6.25,699100
766,95391,182,108,290,54,43,387,47.02842377,27.90697674,74.93540052,13.95348837,11.11111111,634300
767,95401,7,34,41,17,39,97,7.216494845,35.05154639,42.26804124,17.5257732,40.20618557,541300
768,95403,90,160,250,148,151,549,16.39344262,29.143898,45.53734062,26.95810565,27.50455373,588800
769,95404,30,56,86,58,66,210,14.28571429,26.66666667,40.95238095,27.61904762,31.42857143,710100
770,95422,40,113,153,160,388,701,5.706134094,16.11982882,21.82596291,22.82453638,55.34950071,156400
771,95423,3,8,11,21,67,99,3.03030303,8.080808081,11.11111111,21.21212121,67.67676768,223600
772,95425,7,20,27,9,12,48,14.58333333,41.66666667,56.25,18.75,25,556700
773,95426,12,24,36,13,18,67,17.91044776,35.82089552,53.73134328,19.40298507,26.86567164,260400
774,95428,8,25,33,34,94,161,4.968944099,15.52795031,20.49689441,21.11801242,58.38509317,301300
775,95436,7,11,18,15,7,40,17.5,27.5,45,37.5,17.5,578800
776,95437,31,59,90,39,26,155,20,38.06451613,58.06451613,25.16129032,16.77419355,446400
777,95441,4,13,17,20,25,62,6.451612903,20.96774194,27.41935484,32.25806452,40.32258065,952800
778,95448,18,30,48,22,17,87,20.68965517,34.48275862,55.17241379,25.28735632,19.54022989,919400
779,95451,15,46,61,43,42,146,10.2739726,31.50684932,41.78082192,29.45205479,28.76712329,285000
780,95453,47,134,181,161,252,594,7.912457912,22.55892256,30.47138047,27.1043771,42.42424242,342500
781,95454,12,31,43,36,54,133,9.022556391,23.30827068,32.33082707,27.06766917,40.60150376,371700
782,95457,37,82,119,135,281,535,6.91588785,15.3271028,22.24299065,25.23364486,52.52336449,332800
783,95458,5,38,43,48,69,160,3.125,23.75,26.875,30,43.125,234500
784,95459,3,6,9,5,7,21,14.28571429,28.57142857,42.85714286,23.80952381,33.33333333,539800
785,95460,24,58,82,49,37,168,14.28571429,34.52380952,48.80952381,29.16666667,22.02380952,566400
786,95461,40,124,164,113,117,394,10.15228426,31.47208122,41.62436548,28.68020305,29.69543147,315900
787,95462,14,11,25,11,7,43,32.55813953,25.58139535,58.13953488,25.58139535,16.27906977,562500
788,95465,37,29,66,21,15,102,36.2745098,28.43137255,64.70588235,20.58823529,14.70588235,957300
789,95466,20,31,51,19,24,94,21.27659574,32.9787234,54.25531915,20.21276596,25.53191489,583300
790,95467,23,49,72,66,51,189,12.16931217,25.92592593,38.0952381,34.92063492,26.98412698,338300
791,95468,1,3,4,5,9,18,5.555555556,16.66666667,22.22222222,27.77777778,50,494100
792,95472,126,121,247,93,47,387,32.55813953,31.26614987,63.82428941,24.03100775,12.14470284,890700
793,95476,11,27,38,28,25,91,12.08791209,29.67032967,41.75824176,30.76923077,27.47252747,767900
794,95482,26,50,76,53,81,210,12.38095238,23.80952381,36.19047619,25.23809524,38.57142857,402700
795,95485,36,78,114,100,144,358,10.05586592,21.7877095,31.84357542,27.93296089,40.22346369,299100
796,95490,12,55,67,78,145,290,4.137931034,18.96551724,23.10344828,26.89655172,50,337600
797,95501,112,227,339,272,388,999,11.21121121,22.72272272,33.93393393,27.22722723,38.83883884,299400
798,95503,146,345,491,362,567,1420,10.28169014,24.29577465,34.57746479,25.49295775,39.92957746,337600
799,95519,11,37,48,28,15,91,12.08791209,40.65934066,52.74725275,30.76923077,16.48351648,352700
800,95521,285,360,645,291,207,1143,24.9343832,31.49606299,56.43044619,25.45931759,18.11023622,379000
801,95524,94,102,196,56,31,283,33.2155477,36.04240283,69.25795053,19.78798587,10.9540636,484900
802,95525,9,37,46,28,35,109,8.256880734,33.94495413,42.20183486,25.68807339,32.11009174,388200
803,95526,1,7,8,9,4,21,4.761904762,33.33333333,38.0952381,42.85714286,19.04761905,262100
804,95527,13,17,30,18,7,55,23.63636364,30.90909091,54.54545455,32.72727273,12.72727273,272700
805,95528,11,26,37,29,10,76,14.47368421,34.21052632,48.68421053,38.15789474,13.15789474,383900
806,95531,52,79,131,70,92,293,17.74744027,26.96245734,44.70989761,23.89078498,31.39931741,236100
807,95536,22,62,84,81,68,233,9.442060086,26.60944206,36.05150215,34.7639485,29.18454936,443500
808,95540,91,240,331,285,320,936,9.722222222,25.64102564,35.36324786,30.44871795,34.18803419,313500
809,95547,18,49,67,27,8,102,17.64705882,48.03921569,65.68627451,26.47058824,7.843137255,470800
810,95549,2,6,8,5,6,19,10.52631579,31.57894737,42.10526316,26.31578947,31.57894737,536500
811,95551,0,4,4,6,51,61,0,6.557377049,6.557377049,9.836065574,83.60655738,391100
812,95555,2,7,9,1,9,19,10.52631579,36.84210526,47.36842105,5.263157895,47.36842105,325000
813,95558,5,8,13,3,3,19,26.31578947,42.10526316,68.42105263,15.78947368,15.78947368,708300
814,95562,5,29,34,44,90,168,2.976190476,17.26190476,20.23809524,26.19047619,53.57142857,239000
815,95565,18,31,49,36,41,126,14.28571429,24.6031746,38.88888889,28.57142857,32.53968254,284600
816,95570,19,37,56,22,22,100,19,37,56,22,22,446600
817,95585,3,9,12,8,14,34,8.823529412,26.47058824,35.29411765,23.52941176,41.17647059,356700
818,95589,3,10,13,4,3,20,15,50,65,20,15,405300
819,95603,375,544,919,473,520,1912,19.61297071,28.45188285,48.06485356,24.73849372,27.19665272,474900
820,95608,586,870,1456,614,450,2520,23.25396825,34.52380952,57.77777778,24.36507937,17.85714286,448700
821,95614,22,39,61,40,35,136,16.17647059,28.67647059,44.85294118,29.41176471,25.73529412,430400
822,95616,193,69,262,19,9,290,66.55172414,23.79310345,90.34482759,6.551724138,3.103448276,730800
823,95619,1,3,4,10,6,20,5,15,20,50,30,277300
824,95620,83,221,304,242,230,776,10.69587629,28.47938144,39.17525773,31.18556701,29.63917526,458600
825,95621,8,18,26,19,24,69,11.5942029,26.08695652,37.68115942,27.53623188,34.7826087,327900
826,95623,90,91,181,45,37,263,34.22053232,34.60076046,68.82129278,17.11026616,14.06844106,443500
827,95624,1804,2360,4164,1609,1710,7483,24.10797808,31.53815315,55.64613123,21.50207136,22.85179741,473300
828,95627,32,81,113,96,189,398,8.040201005,20.35175879,28.3919598,24.12060302,47.48743719,357900
829,95628,195,206,401,106,61,568,34.33098592,36.26760563,70.59859155,18.66197183,10.73943662,489000
830,95631,57,75,132,73,72,277,20.57761733,27.07581227,47.6534296,26.35379061,25.99277978,409400
831,95633,21,59,80,66,67,213,9.85915493,27.69953052,37.55868545,30.98591549,31.45539906,341700
832,95634,26,60,86,48,83,217,11.98156682,27.64976959,39.63133641,22.11981567,38.24884793,323700
833,95640,24,42,66,49,84,199,12.06030151,21.10552764,33.16582915,24.62311558,42.21105528,345100
834,95642,144,288,432,297,434,1163,12.38177128,24.76354256,37.14531384,25.53740327,37.31728289,348900
835,95648,1123,1685,2808,1246,1047,5101,22.01529112,33.03273868,55.0480298,24.42658302,20.52538718,514000
836,95650,196,127,323,35,24,382,51.30890052,33.2460733,84.55497382,9.162303665,6.282722513,682700
837,95655,1,0,1,1,10,12,8.333333333,0,8.333333333,8.333333333,83.33333333,433100
838,95658,79,84,163,53,30,246,32.11382114,34.14634146,66.2601626,21.54471545,12.19512195,702600
839,95659,68,103,171,91,52,314,21.65605096,32.80254777,54.45859873,28.98089172,16.56050955,435700
840,95660,0,1,1,4,8,13,0,7.692307692,7.692307692,30.76923077,61.53846154,256000
841,95661,567,530,1097,251,169,1517,37.37640079,34.9373764,72.31377719,16.54581411,11.1404087,550300
842,95662,17,8,25,4,0,29,58.62068966,27.5862069,86.20689655,13.79310345,0,408300
843,95666,11,21,32,27,29,88,12.5,23.86363636,36.36363636,30.68181818,32.95454545,288400
844,95667,353,550,903,468,431,1802,19.58934517,30.52164262,50.11098779,25.97114317,23.91786903,434200
845,95668,18,38,56,26,26,108,16.66666667,35.18518519,51.85185185,24.07407407,24.07407407,480000
846,95669,8,24,32,19,39,90,8.888888889,26.66666667,35.55555556,21.11111111,43.33333333,459000
847,95672,236,269,505,181,106,792,29.7979798,33.96464646,63.76262626,22.85353535,13.38383838,573400
848,95674,7,31,38,13,23,74,9.459459459,41.89189189,51.35135135,17.56756757,31.08108108,456300
849,95678,357,393,750,291,230,1271,28.08811959,30.92053501,59.0086546,22.89535799,18.09598741,426500
850,95681,2,4,6,7,13,26,7.692307692,15.38461538,23.07692308,26.92307692,50,312700
851,95682,106,74,180,33,7,220,48.18181818,33.63636364,81.81818182,15,3.181818182,544400
852,95683,63,64,127,34,32,193,32.64248705,33.16062176,65.80310881,17.61658031,16.58031088,550800
853,95684,0,0,0,3,8,11,0,0,0,27.27272727,72.72727273,460700
854,95685,43,67,110,85,103,298,14.4295302,22.48322148,36.91275168,28.52348993,34.56375839,447400
855,95686,12,27,39,32,35,106,11.32075472,25.47169811,36.79245283,30.18867925,33.01886792,311000
856,95688,83,125,208,87,58,353,23.51274788,35.41076487,58.92351275,24.64589235,16.4305949,563300
857,95691,174,197,371,133,129,633,27.48815166,31.12164297,58.60979463,21.01105845,20.37914692,412100
858,95692,93,178,271,168,159,598,15.55183946,29.76588629,45.31772575,28.09364548,26.58862876,310900
859,95693,61,71,132,50,54,236,25.84745763,30.08474576,55.93220339,21.18644068,22.88135593,657600
860,95694,16,21,37,30,33,100,16,21,37,30,33,474000
861,95695,30,75,105,48,57,210,14.28571429,35.71428571,50,22.85714286,27.14285714,402800
862,95701,5,20,25,19,17,61,8.196721311,32.78688525,40.98360656,31.14754098,27.86885246,460400
863,95709,65,87,152,59,57,268,24.25373134,32.46268657,56.71641791,22.01492537,21.26865672,465300
864,95713,78,89,167,116,90,373,20.91152815,23.86058981,44.77211796,31.09919571,24.12868633,422400
865,95720,3,6,9,3,3,15,20,40,60,20,20,365000
866,95726,49,97,146,123,116,385,12.72727273,25.19480519,37.92207792,31.94805195,30.12987013,341300
867,95742,333,235,568,141,116,825,40.36363636,28.48484848,68.84848485,17.09090909,14.06060606,472200
868,95746,781,516,1297,207,106,1610,48.50931677,32.04968944,80.55900621,12.85714286,6.583850932,852900
869,95747,836,990,1826,608,483,2917,28.65958176,33.9389784,62.59856016,20.84333219,16.55810764,537300
870,95757,2062,1977,4039,1175,967,6181,33.36029769,31.98511568,65.34541336,19.00986895,15.64471768,507100
871,95758,850,1072,1922,859,1038,3819,22.25713538,28.07017544,50.32731081,22.49279916,27.17989002,434500
872,95762,848,823,1671,440,235,2346,36.14663257,35.08098892,71.22762148,18.75532822,10.0170503,699100
873,95765,444,420,864,241,218,1323,33.5600907,31.74603175,65.30612245,18.21617536,16.47770219,578900
874,95776,75,88,163,50,46,259,28.95752896,33.97683398,62.93436293,19.30501931,17.76061776,429900
875,95817,38,81,119,119,146,384,9.895833333,21.09375,30.98958333,30.98958333,38.02083333,374200
876,95820,66,127,193,151,114,458,14.41048035,27.72925764,42.13973799,32.96943231,24.89082969,317700
877,95821,139,90,229,66,60,355,39.15492958,25.35211268,64.50704225,18.5915493,16.90140845,374500
878,95823,339,826,1165,1042,1796,4003,8.468648514,20.63452411,29.10317262,26.03047714,44.86635024,285600
879,95825,0,7,7,9,33,49,0,14.28571429,14.28571429,18.36734694,67.34693878,331300
880,95826,24,56,80,49,121,250,9.6,22.4,32,19.6,48.4,349300
881,95828,361,733,1094,944,1703,3741,9.64982625,19.59369153,29.24351778,25.23389468,45.52258754,309800
882,95829,596,762,1358,551,556,2465,24.17849899,30.9127789,55.09127789,22.35294118,22.55578093,429800
883,95831,71,128,199,130,165,494,14.37246964,25.91093117,40.28340081,26.31578947,33.40080972,485300
884,95832,44,64,108,72,74,254,17.32283465,25.19685039,42.51968504,28.34645669,29.13385827,319400
885,95833,15,35,50,17,11,78,19.23076923,44.87179487,64.1025641,21.79487179,14.1025641,349900
886,95834,98,106,204,71,79,354,27.68361582,29.94350282,57.62711864,20.05649718,22.31638418,415800
887,95835,184,172,356,98,62,516,35.65891473,33.33333333,68.99224806,18.99224806,12.01550388,452000
888,95838,19,64,83,69,92,244,7.786885246,26.2295082,34.01639344,28.27868852,37.70491803,276000
889,95843,455,728,1183,556,491,2230,20.40358744,32.64573991,53.04932735,24.93273543,22.01793722,361900
890,95864,142,155,297,92,71,460,30.86956522,33.69565217,64.56521739,20,15.43478261,643200
891,95901,211,618,829,636,1020,2485,8.490945674,24.86921529,33.36016097,25.59356137,41.04627767,269300
892,95914,7,16,23,18,22,63,11.11111111,25.3968254,36.50793651,28.57142857,34.92063492,306900
893,95917,4,18,22,10,16,48,8.333333333,37.5,45.83333333,20.83333333,33.33333333,275000
894,95918,11,24,35,20,24,79,13.92405063,30.37974684,44.30379747,25.3164557,30.37974684,532700
895,95922,3,6,9,12,3,24,12.5,25,37.5,50,12.5,266200
896,95926,406,386,792,219,163,1174,34.58262351,32.879046,67.46166951,18.65417376,13.88415673,370500
897,95928,222,386,608,261,250,1119,19.83914209,34.4950849,54.33422699,23.32439678,22.34137623,388800
898,95932,70,202,272,176,232,680,10.29411765,29.70588235,40,25.88235294,34.11764706,285200
899,95938,86,149,235,148,111,494,17.40890688,30.16194332,47.5708502,29.95951417,22.46963563,477700
900,95939,2,3,5,8,7,20,10,15,25,40,35,138100
901,95942,18,22,40,18,7,65,27.69230769,33.84615385,61.53846154,27.69230769,10.76923077,392300
902,95945,213,375,588,333,378,1299,16.39722864,28.86836028,45.26558891,25.63510393,29.09930716,391400
903,95946,46,86,132,97,85,314,14.64968153,27.38853503,42.03821656,30.89171975,27.07006369,443600
904,95947,2,8,10,5,19,34,5.882352941,23.52941176,29.41176471,14.70588235,55.88235294,240100
905,95948,208,368,576,295,282,1153,18.03989592,31.91673894,49.95663487,25.58542931,24.45793582,260600
906,95949,182,330,512,252,206,970,18.7628866,34.02061856,52.78350515,25.97938144,21.2371134,448500
907,95951,28,75,103,91,126,320,8.75,23.4375,32.1875,28.4375,39.375,240300
908,95953,31,89,120,64,67,251,12.35059761,35.45816733,47.80876494,25.49800797,26.69322709,276300
909,95954,0,1,1,12,15,28,0,3.571428571,3.571428571,42.85714286,53.57142857,194500
910,95957,6,13,19,13,15,47,12.76595745,27.65957447,40.42553191,27.65957447,31.91489362,278300
911,95959,149,188,337,143,96,576,25.86805556,32.63888889,58.50694444,24.82638889,16.66666667,519400
912,95961,110,323,433,442,1064,1939,5.673027334,16.65807117,22.3310985,22.79525529,54.87364621,292400
913,95962,0,14,14,14,34,62,0,22.58064516,22.58064516,22.58064516,54.83870968,297500
914,95963,116,280,396,382,583,1361,8.523144747,20.57310801,29.09625276,28.06759735,42.83614989,278200
915,95965,99,299,398,342,492,1232,8.035714286,24.26948052,32.30519481,27.75974026,39.93506494,216400
916,95966,49,86,135,80,69,284,17.25352113,30.28169014,47.53521127,28.16901408,24.29577465,244400
917,95969,36,83,119,88,67,274,13.13868613,30.2919708,43.43065693,32.11678832,24.45255474,300000
918,95970,5,13,18,16,34,68,7.352941176,19.11764706,26.47058824,23.52941176,50,450000
919,95971,48,98,146,80,64,290,16.55172414,33.79310345,50.34482759,27.5862069,22.06896552,266100
920,95973,24,46,70,21,22,113,21.23893805,40.7079646,61.94690265,18.5840708,19.46902655,402600
921,95979,2,3,5,5,7,17,11.76470588,17.64705882,29.41176471,29.41176471,41.17647059,250000
922,95982,54,100,154,131,127,412,13.10679612,24.27184466,37.37864078,31.7961165,30.82524272,292700
923,95988,56,155,211,209,321,741,7.557354926,20.91767881,28.47503374,28.20512821,43.31983806,244100
924,95991,149,263,412,203,179,794,18.76574307,33.12342569,51.88916877,25.56675063,22.5440806,297900
925,95993,161,201,362,138,113,613,26.26427406,32.78955954,59.05383361,22.51223491,18.43393148,353700
926,96001,688,880,1568,563,506,2637,26.09025408,33.37125521,59.46150929,21.35001896,19.18847175,319700
927,96002,327,613,940,574,684,2198,14.87716106,27.88898999,42.76615105,26.11464968,31.11919927,280900
928,96003,388,710,1098,615,627,2340,16.58119658,30.34188034,46.92307692,26.28205128,26.79487179,299600
929,96007,140,313,453,340,506,1299,10.77752117,24.09545804,34.87297921,26.17397998,38.9530408,235900
930,96008,35,73,108,54,46,208,16.82692308,35.09615385,51.92307692,25.96153846,22.11538462,197700
931,96009,1,7,8,20,29,57,1.754385965,12.28070175,14.03508772,35.0877193,50.87719298,277800
932,96011,1,3,4,3,4,11,9.090909091,27.27272727,36.36363636,27.27272727,36.36363636,115200
933,96013,17,49,66,83,96,245,6.93877551,20,26.93877551,33.87755102,39.18367347,169500
934,96017,3,7,10,9,15,34,8.823529412,20.58823529,29.41176471,26.47058824,44.11764706,258300
935,96019,76,158,234,160,184,578,13.14878893,27.33564014,40.48442907,27.6816609,31.83391003,219700
936,96020,7,16,23,18,12,53,13.20754717,30.18867925,43.39622642,33.96226415,22.64150943,229200
937,96021,125,348,473,403,772,1648,7.584951456,21.11650485,28.70145631,24.4538835,46.84466019,212900
938,96022,306,451,757,399,336,1492,20.50938338,30.22788204,50.73726542,26.74262735,22.52010724,263300
939,96023,3,3,6,6,6,18,16.66666667,16.66666667,33.33333333,33.33333333,33.33333333,120300
940,96024,37,40,77,20,11,108,34.25925926,37.03703704,71.2962963,18.51851852,10.18518519,278800
941,96025,4,10,14,11,23,48,8.333333333,20.83333333,29.16666667,22.91666667,47.91666667,232200
942,96027,19,26,45,30,28,103,18.44660194,25.24271845,43.68932039,29.12621359,27.18446602,240800
943,96028,16,38,54,57,41,152,10.52631579,25,35.52631579,37.5,26.97368421,286100
944,96029,6,8,14,7,10,31,19.35483871,25.80645161,45.16129032,22.58064516,32.25806452,311500
945,96032,40,63,103,52,49,204,19.60784314,30.88235294,50.49019608,25.49019608,24.01960784,253400
946,96033,0,10,10,2,1,13,0,76.92307692,76.92307692,15.38461538,7.692307692,130000
947,96034,2,4,6,7,13,26,7.692307692,15.38461538,23.07692308,26.92307692,50,305300
948,96038,18,37,55,39,32,126,14.28571429,29.36507937,43.65079365,30.95238095,25.3968254,213900
949,96039,2,7,9,13,29,51,3.921568627,13.7254902,17.64705882,25.49019608,56.8627451,143800
950,96041,33,33,66,32,31,129,25.58139535,25.58139535,51.1627907,24.80620155,24.03100775,310100
951,96044,0,6,6,5,20,31,0,19.35483871,19.35483871,16.12903226,64.51612903,177100
952,96047,0,7,7,16,10,33,0,21.21212121,21.21212121,48.48484848,30.3030303,367600
953,96048,23,13,36,9,3,48,47.91666667,27.08333333,75,18.75,6.25,330600
954,96052,1,8,9,14,16,39,2.564102564,20.51282051,23.07692308,35.8974359,41.02564103,282500
955,96055,59,136,195,117,113,425,13.88235294,32,45.88235294,27.52941176,26.58823529,229300
956,96056,14,37,51,17,24,92,15.2173913,40.2173913,55.43478261,18.47826087,26.08695652,266500
957,96057,4,12,16,12,17,45,8.888888889,26.66666667,35.55555556,26.66666667,37.77777778,237500
958,96062,47,67,114,24,20,158,29.74683544,42.40506329,72.15189873,15.18987342,12.65822785,325000
959,96064,30,93,123,83,96,302,9.933774834,30.79470199,40.72847682,27.48344371,31.78807947,199100
960,96067,85,120,205,74,82,361,23.54570637,33.24099723,56.7867036,20.49861496,22.71468144,320300
961,96069,2,14,16,8,8,32,6.25,43.75,50,25,25,327000
962,96073,157,224,381,125,79,585,26.83760684,38.29059829,65.12820513,21.36752137,13.5042735,451900
963,96080,244,586,830,605,891,2326,10.49011178,25.19346518,35.68357696,26.01031814,38.3061049,250400
964,96087,8,18,26,20,18,64,12.5,28.125,40.625,31.25,28.125,334500
965,96091,3,5,8,0,5,13,23.07692308,38.46153846,61.53846154,0,38.46153846,321300
966,96092,6,20,26,17,11,54,11.11111111,37.03703704,48.14814815,31.48148148,20.37037037,275000
967,96093,39,72,111,65,58,234,16.66666667,30.76923077,47.43589744,27.77777778,24.78632479,298300
968,96094,22,49,71,44,41,156,14.1025641,31.41025641,45.51282051,28.20512821,26.28205128,248600
969,96097,84,175,259,205,272,736,11.41304348,23.77717391,35.19021739,27.85326087,36.95652174,190300
970,96101,41,101,142,137,135,414,9.903381643,24.39613527,34.29951691,33.09178744,32.60869565,145900
971,96104,7,28,35,15,16,66,10.60606061,42.42424242,53.03030303,22.72727273,24.24242424,174400
972,96107,23,30,53,20,10,83,27.71084337,36.14457831,63.85542169,24.09638554,12.04819277,245800
973,96109,27,37,64,53,48,165,16.36363636,22.42424242,38.78787879,32.12121212,29.09090909,186400
974,96114,17,56,73,66,81,220,7.727272727,25.45454545,33.18181818,30,36.81818182,295100
975,96118,8,14,22,20,7,49,16.32653061,28.57142857,44.89795918,40.81632653,14.28571429,215000
976,96120,10,10,20,5,10,35,28.57142857,28.57142857,57.14285714,14.28571429,28.57142857,375300
977,96122,15,41,56,42,29,127,11.81102362,32.28346457,44.09448819,33.07086614,22.83464567,198000
978,96130,161,318,479,278,422,1179,13.65564037,26.97201018,40.62765055,23.5793045,35.79304495,218100
979,96134,9,48,57,56,91,204,4.411764706,23.52941176,27.94117647,27.45098039,44.60784314,130100
980,96137,10,26,36,27,30,93,10.75268817,27.95698925,38.70967742,29.03225806,32.25806452,236300
981,96143,13,24,37,23,46,106,12.26415094,22.64150943,34.90566038,21.69811321,43.39622642,542100
982,96145,147,186,333,139,131,603,24.37810945,30.84577114,55.2238806,23.05140962,21.72470978,785700
983,96146,65,47,112,11,1,124,52.41935484,37.90322581,90.32258065,8.870967742,0.806451613,1203900
984,96161,348,451,799,282,267,1348,25.81602374,33.45697329,59.27299703,20.91988131,19.80712166,653600
},,,,,,,,,,,,,