Index,Zip Code,Students Standard Exceeded_math2021,Students Standard Met_math2021,Students Standard Met and Above_math2021,Students Standard Nearly Met_math2021,Students Standard Not Met_math2021,Students with Scores_math2021,Percentage Standard Exceeded_math2021,Percentage Standard Met_math2021,Percentage Standard Met and Above_math2021,Percentage Standard Nearly Met_math2021,Percentage Standard Not Met_math2021,Median Mortgage
0,90001,10,45,55,114,225,394,2.538071066,11.4213198,13.95939086,28.93401015,57.10659898,425200
1,90002,1,8,9,24,62,95,1.052631579,8.421052632,9.473684211,25.26315789,65.26315789,411500
2,90003,15,80,95,152,320,567,2.645502646,14.10934744,16.75485009,26.80776014,56.43738977,430800
3,90004,13,28,41,20,43,104,12.5,26.92307692,39.42307692,19.23076923,41.34615385,1148400
4,90005,46,78,124,122,214,460,10,16.95652174,26.95652174,26.52173913,46.52173913,964700
5,90006,15,23,38,36,46,120,12.5,19.16666667,31.66666667,30,38.33333333,716900
6,90007,61,115,176,268,559,1003,6.081754736,11.46560319,17.54735793,26.71984048,55.7328016,717300
7,90010,3,8,11,19,37,67,4.47761194,11.94029851,16.41791045,28.35820896,55.2238806,822100
8,90011,24,89,113,217,446,776,3.092783505,11.46907216,14.56185567,27.96391753,57.4742268,452100
9,90012,85,111,196,129,155,480,17.70833333,23.125,40.83333333,26.875,32.29166667,633000
10,90013,50,72,122,95,158,375,13.33333333,19.2,32.53333333,25.33333333,42.13333333,664800
11,90015,13,40,53,115,250,418,3.110047847,9.56937799,12.67942584,27.51196172,59.80861244,715000
12,90016,15,56,71,158,373,602,2.491694352,9.302325581,11.79401993,26.24584718,61.96013289,677500
13,90017,14,53,67,128,322,517,2.707930368,10.25145068,12.95938104,24.7582205,62.28239845,697100
14,90018,15,33,48,42,74,164,9.146341463,20.12195122,29.26829268,25.6097561,45.12195122,704300
15,90019,22,48,70,81,148,299,7.357859532,16.05351171,23.41137124,27.090301,49.49832776,1033900
16,90020,27,82,109,139,189,437,6.178489703,18.76430206,24.94279176,31.80778032,43.24942792,650300
17,90021,0,4,4,11,60,75,0,5.333333333,5.333333333,14.66666667,80,1013900
18,90022,69,235,304,390,733,1427,4.835318851,16.46811493,21.30343378,27.33006307,51.36650315,471000
19,90023,9,38,47,79,109,235,3.829787234,16.17021277,20,33.61702128,46.38297872,479600
20,90025,162,185,347,222,227,796,20.35175879,23.24120603,43.59296482,27.88944724,28.51758794,905900
21,90026,25,63,88,200,408,696,3.591954023,9.051724138,12.64367816,28.73563218,58.62068966,962100
22,90027,76,83,159,75,46,280,27.14285714,29.64285714,56.78571429,26.78571429,16.42857143,1287200
23,90028,20,51,71,93,175,339,5.899705015,15.04424779,20.9439528,27.43362832,51.62241888,723000
24,90031,83,181,264,293,577,1134,7.319223986,15.96119929,23.28042328,25.8377425,50.88183422,616900
25,90032,20,52,72,78,119,269,7.434944238,19.33085502,26.76579926,28.99628253,44.23791822,605400
26,90033,155,262,417,348,483,1248,12.41987179,20.99358974,33.41346154,27.88461538,38.70192308,538900
27,90034,36,75,111,113,129,353,10.19830028,21.24645892,31.44475921,32.01133144,36.54390935,1152500
28,90035,68,63,131,34,47,212,32.0754717,29.71698113,61.79245283,16.03773585,22.16981132,1494600
29,90036,0,0,0,2,9,11,0,0,0,18.18181818,81.81818182,1634700
30,90037,24,56,80,95,196,371,6.469002695,15.09433962,21.56334232,25.606469,52.83018868,502000
31,90040,20,72,92,152,376,620,3.225806452,11.61290323,14.83870968,24.51612903,60.64516129,452100
32,90041,60,64,124,88,177,389,15.42416452,16.45244216,31.87660668,22.62210797,45.50128535,886800
33,90042,37,65,102,82,92,276,13.4057971,23.55072464,36.95652174,29.71014493,33.33333333,731600
34,90043,35,96,131,256,585,972,3.600823045,9.87654321,13.47736626,26.33744856,60.18518519,684500
35,90044,1,11,12,27,73,112,0.892857143,9.821428571,10.71428571,24.10714286,65.17857143,461200
36,90045,157,133,290,159,176,625,25.12,21.28,46.4,25.44,28.16,1103500
37,90046,43,66,109,69,96,274,15.69343066,24.08759124,39.7810219,25.18248175,35.03649635,1290400
38,90047,40,96,136,204,491,831,4.813477738,11.55234657,16.36582431,24.54873646,59.08543923,519400
39,90057,66,72,138,130,173,441,14.96598639,16.32653061,31.29251701,29.47845805,39.22902494,576200
40,90059,23,90,113,120,129,362,6.35359116,24.86187845,31.21546961,33.14917127,35.63535912,415100
41,90061,0,11,11,25,43,79,0,13.92405063,13.92405063,31.64556962,54.43037975,438800
42,90062,2,7,9,27,127,163,1.226993865,4.294478528,5.521472393,16.56441718,77.91411043,550600
43,90063,14,50,64,154,384,602,2.325581395,8.305647841,10.63122924,25.58139535,63.78737542,481100
44,90064,1,2,3,6,17,26,3.846153846,7.692307692,11.53846154,23.07692308,65.38461538,1388300
45,90065,102,109,211,161,199,571,17.86339755,19.08931699,36.95271454,28.19614711,34.85113835,833400
46,90066,42,73,115,89,142,346,12.13872832,21.0982659,33.23699422,25.72254335,41.04046243,1282100
47,90201,208,426,634,898,2162,3694,5.630752572,11.5322144,17.16296697,24.30969139,58.52734164,440500
48,90210,85,110,195,67,39,301,28.23920266,36.5448505,64.78405316,22.25913621,12.95681063,2000000
49,90211,127,88,215,103,42,360,35.27777778,24.44444444,59.72222222,28.61111111,11.66666667,2000000
50,90212,311,263,574,257,224,1055,29.47867299,24.92890995,54.40758294,24.36018957,21.23222749,2000000
51,90230,722,642,1364,619,517,2500,28.88,25.68,54.56,24.76,20.68,849200
52,90232,120,107,227,121,170,518,23.16602317,20.65637066,43.82239382,23.35907336,32.81853282,1219100
53,90245,611,476,1087,421,272,1780,34.3258427,26.74157303,61.06741573,23.65168539,15.28089888,1244200
54,90248,8,40,48,85,158,291,2.749140893,13.74570447,16.49484536,29.20962199,54.29553265,571200
55,90250,60,94,154,209,388,751,7.989347537,12.51664447,20.50599201,27.82956059,51.6644474,661400
56,90255,52,160,212,255,332,799,6.508135169,20.02503129,26.53316646,31.91489362,41.55193992,455000
57,90260,45,142,187,275,628,1090,4.128440367,13.02752294,17.1559633,25.2293578,57.6146789,597300
58,90262,239,646,885,1501,3645,6031,3.962858564,10.71132482,14.67418339,24.88807826,60.43773835,449600
59,90265,28,30,58,32,27,117,23.93162393,25.64102564,49.57264957,27.35042735,23.07692308,2000000
60,90266,38,17,55,15,9,79,48.10126582,21.51898734,69.62025316,18.98734177,11.39240506,2000000
61,90270,17,65,82,98,185,365,4.657534247,17.80821918,22.46575342,26.84931507,50.68493151,481800
62,90280,105,312,417,514,839,1770,5.93220339,17.62711864,23.55932203,29.03954802,47.40112994,470200
63,90291,97,76,173,56,32,261,37.16475096,29.11877395,66.2835249,21.4559387,12.2605364,1899800
64,90301,59,159,218,389,1145,1752,3.367579909,9.075342466,12.44292237,22.20319635,65.35388128,547900
65,90302,137,276,413,478,819,1710,8.011695906,16.14035088,24.15204678,27.95321637,47.89473684,590000
66,90303,36,83,119,206,628,953,3.777544596,8.70933893,12.48688353,21.61594963,65.89716684,606100
67,90304,11,30,41,48,43,132,8.333333333,22.72727273,31.06060606,36.36363636,32.57575758,586600
68,90305,0,2,2,12,65,79,0,2.53164557,2.53164557,15.18987342,82.27848101,646500
69,90601,54,100,154,95,103,352,15.34090909,28.40909091,43.75,26.98863636,29.26136364,626500
70,90603,32,57,89,60,79,228,14.03508772,25,39.03508772,26.31578947,34.64912281,649600
71,90604,245,372,617,528,512,1657,14.78575739,22.45021123,37.23596862,31.86481593,30.89921545,591400
72,90605,99,155,254,180,150,584,16.95205479,26.54109589,43.49315068,30.82191781,25.68493151,556000
73,90606,91,180,271,269,394,934,9.743040685,19.27194861,29.01498929,28.80085653,42.18415418,509600
74,90620,46,60,106,70,76,252,18.25396825,23.80952381,42.06349206,27.77777778,30.15873016,622700
75,90621,31,59,90,91,142,323,9.59752322,18.26625387,27.86377709,28.17337461,43.9628483,643200
76,90623,307,278,585,314,380,1279,24.00312744,21.73573104,45.73885848,24.55043002,29.71071149,739200
77,90630,1036,426,1462,414,404,2280,45.43859649,18.68421053,64.12280702,18.15789474,17.71929825,700100
78,90631,215,369,584,486,526,1596,13.47117794,23.12030075,36.5914787,30.45112782,32.95739348,628900
79,90638,20,22,42,10,7,59,33.89830508,37.28813559,71.18644068,16.94915254,11.86440678,630100
80,90640,234,510,744,1114,2614,4472,5.23255814,11.40429338,16.63685152,24.91055456,58.45259392,558600
81,90650,31,66,97,125,196,418,7.416267943,15.78947368,23.20574163,29.90430622,46.88995215,487800
82,90660,65,126,191,162,255,608,10.69078947,20.72368421,31.41447368,26.64473684,41.94078947,490300
83,90670,86,155,241,177,202,620,13.87096774,25,38.87096774,28.5483871,32.58064516,492100
84,90701,6,11,17,9,2,28,21.42857143,39.28571429,60.71428571,32.14285714,7.142857143,635000
85,90703,274,90,364,43,9,416,65.86538462,21.63461538,87.5,10.33653846,2.163461538,762700
86,90704,14,34,48,58,134,240,5.833333333,14.16666667,20,24.16666667,55.83333333,863800
87,90706,1,13,14,9,4,27,3.703703704,48.14814815,51.85185185,33.33333333,14.81481481,535300
88,90710,36,79,115,130,223,468,7.692307692,16.88034188,24.57264957,27.77777778,47.64957265,523400
89,90712,126,199,325,318,525,1168,10.78767123,17.03767123,27.82534247,27.2260274,44.94863014,622800
90,90713,201,311,512,381,376,1269,15.8392435,24.50748621,40.34672971,30.02364066,29.62962963,638600
91,90715,6,4,10,3,2,15,40,26.66666667,66.66666667,20,13.33333333,555400
92,90716,0,3,3,4,5,12,0,25,25,33.33333333,41.66666667,442000
93,90720,197,219,416,146,133,695,28.34532374,31.51079137,59.85611511,21.00719424,19.13669065,1004200
94,90723,232,621,853,1507,3272,5632,4.119318182,11.02627841,15.14559659,26.7578125,58.09659091,411900
95,90731,21,64,85,73,119,277,7.581227437,23.10469314,30.68592058,26.35379061,42.96028881,657700
96,90744,52,113,165,167,279,611,8.510638298,18.49427169,27.00490998,27.33224223,45.66284779,471000
97,90745,28,80,108,132,228,468,5.982905983,17.09401709,23.07692308,28.20512821,48.71794872,516000
98,90746,3,12,15,16,13,44,6.818181818,27.27272727,34.09090909,36.36363636,29.54545455,585600
99,90755,102,167,269,303,480,1052,9.69581749,15.87452471,25.57034221,28.80228137,45.62737643,553100
100,90802,118,202,320,400,773,1493,7.9035499,13.52980576,21.43335566,26.79169457,51.77494977,460300
101,90803,426,341,767,323,274,1364,31.23167155,25,56.23167155,23.68035191,20.08797654,943000
102,90804,213,341,554,642,1047,2243,9.496210432,15.20285332,24.69906375,28.62238074,46.67855551,541000
103,90805,262,653,915,1302,2585,4802,5.456059975,13.59850062,19.0545606,27.11370262,53.83173678,469100
104,90806,143,233,376,417,723,1516,9.432717678,15.36939314,24.80211082,27.50659631,47.69129288,568400
105,90807,441,467,908,586,700,2194,20.10027347,21.28532361,41.38559708,26.70920693,31.90519599,661100
106,90808,1078,1037,2115,1083,877,4075,26.45398773,25.44785276,51.90184049,26.57668712,21.52147239,708300
107,90810,178,332,510,658,1101,2269,7.84486558,14.63199647,22.47686205,28.99955928,48.52357867,464500
108,90813,286,437,723,663,1264,2650,10.79245283,16.49056604,27.28301887,25.01886792,47.69811321,430500
109,90814,93,126,219,126,162,507,18.34319527,24.85207101,43.19526627,24.85207101,31.95266272,738900
110,90815,734,728,1462,722,502,2686,27.32688012,27.10349963,54.43037975,26.88011914,18.68950112,701600
111,91001,13,19,32,39,81,152,8.552631579,12.5,21.05263158,25.65789474,53.28947368,887100
112,91006,4,1,5,2,8,15,26.66666667,6.666666667,33.33333333,13.33333333,53.33333333,1074000
113,91007,268,136,404,97,68,569,47.10017575,23.90158172,71.00175747,17.04745167,11.95079086,1056600
114,91008,104,134,238,161,197,596,17.44966443,22.48322148,39.93288591,27.01342282,33.05369128,1414100
115,91010,155,210,365,347,482,1194,12.98157454,17.5879397,30.56951424,29.06197655,40.36850921,560900
116,91016,401,465,866,569,751,2186,18.34400732,21.27172919,39.61573651,26.02927722,34.35498628,707400
117,91042,49,48,97,50,45,192,25.52083333,25,50.52083333,26.04166667,23.4375,617400
118,91101,1,1,2,1,12,15,6.666666667,6.666666667,13.33333333,6.666666667,80,615200
119,91103,3,3,6,4,3,13,23.07692308,23.07692308,46.15384615,30.76923077,23.07692308,780200
120,91104,46,57,103,42,52,197,23.35025381,28.93401015,52.28426396,21.31979695,26.39593909,836500
121,91106,9,21,30,24,44,98,9.183673469,21.42857143,30.6122449,24.48979592,44.89795918,811200
122,91107,46,68,114,79,89,282,16.31205674,24.11347518,40.42553191,28.0141844,31.56028369,913700
123,91108,842,325,1167,150,87,1404,59.97150997,23.14814815,83.11965812,10.68376068,6.196581197,2000000
124,91202,72,79,151,91,107,349,20.63037249,22.63610315,43.26647564,26.07449857,30.65902579,876700
125,91205,52,67,119,102,133,354,14.68926554,18.92655367,33.61581921,28.81355932,37.57062147,677200
126,91206,0,1,1,5,60,66,0,1.515151515,1.515151515,7.575757576,90.90909091,910500
127,91214,334,257,591,157,96,844,39.57345972,30.45023697,70.02369668,18.60189573,11.37440758,851700
128,91301,313,304,617,355,232,1204,25.99667774,25.24916944,51.24584718,29.48504983,19.26910299,871000
129,91302,448,479,927,434,280,1641,27.30042657,29.18951859,56.48994516,26.44728824,17.06276661,1341400
130,91303,6,35,41,65,108,214,2.803738318,16.35514019,19.1588785,30.37383178,50.46728972,536400
131,91311,79,120,199,127,145,471,16.77282378,25.47770701,42.25053079,26.96390658,30.78556263,679000
132,91320,57,27,84,25,31,140,40.71428571,19.28571429,60,17.85714286,22.14285714,755800
133,91321,246,301,547,413,518,1478,16.64411367,20.36535859,37.00947226,27.94316644,35.0473613,513500
134,91324,5,7,12,26,87,125,4,5.6,9.6,20.8,69.6,680200
135,91325,10,30,40,41,66,147,6.802721088,20.40816327,27.21088435,27.89115646,44.89795918,720900
136,91331,9,47,56,169,380,605,1.487603306,7.768595041,9.256198347,27.9338843,62.80991736,487600
137,91335,204,264,468,289,324,1081,18.87141536,24.42183164,43.29324699,26.73450509,29.97224792,580500
138,91340,36,113,149,277,421,847,4.250295159,13.34120425,17.59149941,32.70365998,49.70484061,515000
139,91342,121,263,384,496,1034,1914,6.32183908,13.74085684,20.06269592,25.91431557,54.02298851,520900
140,91343,54,157,211,276,482,969,5.572755418,16.20227038,21.7750258,28.48297214,49.74200206,608500
141,91344,69,112,181,150,213,544,12.68382353,20.58823529,33.27205882,27.57352941,39.15441176,690300
142,91352,57,122,179,177,455,811,7.028360049,15.0431566,22.07151665,21.82490752,56.10357583,584100
143,91355,250,195,445,169,194,808,30.94059406,24.13366337,55.07425743,20.91584158,24.00990099,600200
144,91360,115,112,227,98,79,404,28.46534653,27.72277228,56.18811881,24.25742574,19.55445545,735100
145,91361,236,257,493,360,469,1322,17.85173979,19.44024206,37.29198185,27.23146747,35.47655068,1042900
146,91362,194,162,356,114,107,577,33.62218371,28.0762565,61.69844021,19.75736568,18.54419411,878300
147,91364,185,265,450,311,255,1016,18.20866142,26.08267717,44.29133858,30.61023622,25.0984252,949000
148,91367,162,173,335,165,161,661,24.50832073,26.17246596,50.68078669,24.96217852,24.3570348,786200
149,91377,914,595,1509,371,232,2112,43.27651515,28.17234848,71.44886364,17.56628788,10.98484848,823300
150,91381,548,303,851,187,83,1121,48.88492417,27.029438,75.91436218,16.68153434,7.404103479,851300
151,91401,24,72,96,88,167,351,6.837606838,20.51282051,27.35042735,25.07122507,47.57834758,798900
152,91402,15,28,43,57,120,220,6.818181818,12.72727273,19.54545455,25.90909091,54.54545455,483700
153,91403,24,26,50,45,50,145,16.55172414,17.93103448,34.48275862,31.03448276,34.48275862,1129100
154,91405,29,75,104,155,255,514,5.642023346,14.59143969,20.23346304,30.15564202,49.61089494,581600
155,91406,75,161,236,299,379,914,8.205689278,17.61487965,25.82056893,32.71334792,41.46608315,608600
156,91411,69,80,149,93,135,377,18.30238727,21.22015915,39.52254642,24.66843501,35.80901857,759300
157,91501,38,50,88,85,86,259,14.67181467,19.30501931,33.97683398,32.81853282,33.2046332,827400
158,91502,23,19,42,12,10,64,35.9375,29.6875,65.625,18.75,15.625,761400
159,91504,72,83,155,106,88,349,20.63037249,23.78223496,44.41260745,30.37249284,25.21489971,819100
160,91505,88,146,234,168,120,522,16.85823755,27.96934866,44.82758621,32.18390805,22.98850575,812500
161,91506,124,150,274,196,179,649,19.10631741,23.11248074,42.21879815,30.20030817,27.58089368,850600
162,91601,178,94,272,125,230,627,28.3891547,14.99202552,43.38118022,19.93620415,36.68261563,744500
163,91701,122,136,258,120,83,461,26.46420824,29.5010846,55.96529284,26.03036876,18.00433839,577200
164,91706,407,770,1177,1636,3411,6224,6.539203085,12.3714653,18.91066838,26.28534704,54.80398458,465900
165,91709,50,42,92,58,42,192,26.04166667,21.875,47.91666667,30.20833333,21.875,676800
166,91711,57,44,101,26,14,141,40.42553191,31.20567376,71.63120567,18.43971631,9.929078014,714400
167,91724,44,65,109,76,50,235,18.72340426,27.65957447,46.38297872,32.34042553,21.27659574,613400
168,91737,145,133,278,88,69,435,33.33333333,30.57471264,63.90804598,20.22988506,15.86206897,659500
169,91739,80,119,199,141,126,466,17.16738197,25.53648069,42.70386266,30.25751073,27.03862661,648400
170,91744,32,57,89,85,130,304,10.52631579,18.75,29.27631579,27.96052632,42.76315789,463200
171,91746,18,27,45,38,95,178,10.11235955,15.16853933,25.28089888,21.34831461,53.37078652,488400
172,91748,103,84,187,71,121,379,27.176781,22.16358839,49.34036939,18.73350923,31.92612137,663600
173,91750,0,0,0,0,25,25,0,0,0,0,100,630400
174,91754,16,45,61,58,76,195,8.205128205,23.07692308,31.28205128,29.74358974,38.97435897,687700
175,91755,90,68,158,127,281,566,15.90106007,12.01413428,27.91519435,22.43816254,49.64664311,639900
176,91761,24,53,77,53,58,188,12.76595745,28.19148936,40.95744681,28.19148936,30.85106383,452900
177,91762,70,135,205,204,273,682,10.26392962,19.79472141,30.05865103,29.91202346,40.02932551,437700
178,91763,43,71,114,70,115,299,14.3812709,23.7458194,38.1270903,23.41137124,38.46153846,423700
179,91764,0,1,1,3,10,14,0,7.142857143,7.142857143,21.42857143,71.42857143,415600
180,91765,254,120,374,64,46,484,52.47933884,24.79338843,77.27272727,13.2231405,9.504132231,709800
181,91766,15,43,58,129,309,496,3.024193548,8.669354839,11.69354839,26.00806452,62.2983871,452700
182,91767,15,47,62,116,375,553,2.712477396,8.499095841,11.21157324,20.97649186,67.8119349,449500
183,91768,22,45,67,69,40,176,12.5,25.56818182,38.06818182,39.20454545,22.72727273,427500
184,91770,39,43,82,44,54,180,21.66666667,23.88888889,45.55555556,24.44444444,30,601300
185,91773,6,5,11,4,13,28,21.42857143,17.85714286,39.28571429,14.28571429,46.42857143,625400
186,91776,92,52,144,40,45,229,40.17467249,22.70742358,62.88209607,17.46724891,19.65065502,698900
187,91789,238,117,355,79,68,502,47.41035857,23.30677291,70.71713147,15.73705179,13.54581673,790500
188,91905,2,9,11,25,48,84,2.380952381,10.71428571,13.0952381,29.76190476,57.14285714,280400
189,91906,4,30,34,54,179,267,1.498127341,11.23595506,12.7340824,20.2247191,67.0411985,282800
190,91910,668,750,1418,1040,1334,3792,17.61603376,19.77848101,37.39451477,27.42616034,35.17932489,549100
191,91911,48,210,258,295,503,1056,4.545454545,19.88636364,24.43181818,27.93560606,47.63257576,485300
192,91913,205,313,518,296,211,1025,20,30.53658537,50.53658537,28.87804878,20.58536585,578600
193,91914,310,275,585,284,276,1145,27.07423581,24.01746725,51.09170306,24.80349345,24.10480349,739300
194,91915,173,165,338,137,81,556,31.11510791,29.67625899,60.79136691,24.64028777,14.56834532,604600
195,91916,4,24,28,28,43,99,4.04040404,24.24242424,28.28282828,28.28282828,43.43434343,479600
196,91932,64,152,216,377,859,1452,4.407713499,10.46831956,14.87603306,25.96418733,59.15977961,639200
197,91935,19,36,55,47,87,189,10.05291005,19.04761905,29.1005291,24.86772487,46.03174603,681300
198,91941,34,61,95,108,110,313,10.86261981,19.48881789,30.3514377,34.50479233,35.14376997,684900
199,91942,20,32,52,30,50,132,15.15151515,24.24242424,39.39393939,22.72727273,37.87878788,578600
200,91950,124,290,414,552,1192,2158,5.746061168,13.43836886,19.18443003,25.57924004,55.23632994,450700
201,91962,18,32,50,78,148,276,6.52173913,11.5942029,18.11594203,28.26086957,53.62318841,433300
202,91963,3,12,15,25,117,157,1.910828025,7.643312102,9.554140127,15.92356688,74.52229299,350000
203,91977,48,87,135,127,181,443,10.83521445,19.63882619,30.47404063,28.66817156,40.85778781,493000
204,91978,52,125,177,106,107,390,13.33333333,32.05128205,45.38461538,27.17948718,27.43589744,454100
205,92004,6,9,15,37,71,123,4.87804878,7.317073171,12.19512195,30.08130081,57.72357724,320600
206,92019,446,568,1014,805,848,2667,16.72290964,21.29733783,38.02024747,30.18372703,31.7960255,576700
207,92020,437,424,861,448,400,1709,25.57050907,24.80983031,50.38033938,26.21416033,23.40550029,576200
208,92021,19,43,62,78,185,325,5.846153846,13.23076923,19.07692308,24,56.92307692,469100
209,92024,87,84,171,64,29,264,32.95454545,31.81818182,64.77272727,24.24242424,10.98484848,1063400
210,92025,28,62,90,90,218,398,7.035175879,15.57788945,22.61306533,22.61306533,54.77386935,558600
211,92026,19,51,70,87,238,395,4.810126582,12.91139241,17.72151899,22.02531646,60.25316456,539900
212,92027,274,407,681,501,492,1674,16.36798088,24.3130227,40.68100358,29.92831541,29.390681,493300
213,92028,41,69,110,88,151,349,11.747851,19.77077364,31.51862464,25.21489971,43.26647564,627900
214,92029,19,46,65,62,57,184,10.32608696,25,35.32608696,33.69565217,30.97826087,690900
215,92036,8,11,19,16,27,62,12.90322581,17.74193548,30.64516129,25.80645161,43.5483871,425900
216,92040,20,30,50,78,155,283,7.067137809,10.60070671,17.66784452,27.56183746,54.77031802,540200
217,92054,9,46,55,52,127,234,3.846153846,19.65811966,23.5042735,22.22222222,54.27350427,648800
218,92056,0,7,7,15,94,116,0,6.034482759,6.034482759,12.93103448,81.03448276,583700
219,92057,161,188,349,235,267,851,18.91891892,22.09165687,41.01057579,27.61457109,31.37485311,530600
220,92061,0,5,5,23,73,101,0,4.95049505,4.95049505,22.77227723,72.27722772,611500
221,92064,296,328,624,530,669,1823,16.23697202,17.99232035,34.22929238,29.07295666,36.69775096,767500
222,92065,25,72,97,80,115,292,8.561643836,24.65753425,33.21917808,27.39726027,39.38356164,593100
223,92067,226,94,320,58,35,413,54.72154964,22.76029056,77.48184019,14.04358354,8.474576271,2000000
224,92070,7,8,15,1,1,17,41.17647059,47.05882353,88.23529412,5.882352941,5.882352941,335700
225,92071,741,973,1714,1059,1044,3817,19.41315169,25.49122347,44.90437516,27.74430181,27.35132303,524100
226,92078,1,5,6,8,6,20,5,25,30,40,30,665300
227,92081,41,88,129,95,92,316,12.97468354,27.84810127,40.82278481,30.06329114,29.11392405,599400
228,92082,73,184,257,388,929,1574,4.637865311,11.68996188,16.32782719,24.65057179,59.02160102,620700
229,92083,0,4,4,2,50,56,0,7.142857143,7.142857143,3.571428571,89.28571429,467600
230,92084,17,47,64,102,220,386,4.404145078,12.1761658,16.58031088,26.42487047,56.99481865,600600
231,92086,1,2,3,2,23,28,3.571428571,7.142857143,10.71428571,7.142857143,82.14285714,265800
232,92101,27,54,81,121,228,430,6.279069767,12.55813953,18.8372093,28.13953488,53.02325581,626000
233,92102,31,90,121,255,575,951,3.259726604,9.463722397,12.723449,26.81388013,60.46267087,477100
234,92103,25,36,61,42,33,136,18.38235294,26.47058824,44.85294118,30.88235294,24.26470588,835300
235,92105,8,12,20,15,64,99,8.080808081,12.12121212,20.2020202,15.15151515,64.64646465,459200
236,92108,3,18,21,30,49,100,3,18,21,30,49,469300
237,92111,97,116,213,129,209,551,17.60435572,21.05263158,38.6569873,23.41197822,37.93103448,604600
238,92113,1,1,2,14,83,99,1.01010101,1.01010101,2.02020202,14.14141414,83.83838384,406600
239,92114,28,52,80,117,207,404,6.930693069,12.87128713,19.8019802,28.96039604,51.23762376,461500
240,92115,6,32,38,91,252,381,1.57480315,8.398950131,9.973753281,23.88451444,66.14173228,580800
241,92118,361,365,726,288,159,1173,30.77578858,31.11679454,61.89258312,24.55242967,13.55498721,1656900
242,92122,11,5,16,7,4,27,40.74074074,18.51851852,59.25925926,25.92592593,14.81481481,780000
243,92123,134,135,269,137,144,550,24.36363636,24.54545455,48.90909091,24.90909091,26.18181818,600900
244,92131,33,31,64,22,32,118,27.96610169,26.27118644,54.23728814,18.6440678,27.11864407,885500
245,92154,290,642,932,1179,2313,4424,6.555153707,14.51175407,21.06690778,26.65009042,52.28300181,477900
246,92173,3,18,21,66,268,355,0.845070423,5.070422535,5.915492958,18.5915493,75.49295775,388700
247,92201,32,123,155,271,518,944,3.389830508,13.02966102,16.41949153,28.70762712,54.87288136,272400
248,92223,227,418,645,721,1010,2376,9.553872054,17.59259259,27.14646465,30.34511785,42.50841751,354000
249,92227,43,86,129,136,174,439,9.79498861,19.58997722,29.38496583,30.97949886,39.63553531,226700
250,92231,67,123,190,177,290,657,10.1978691,18.72146119,28.91933029,26.94063927,44.14003044,233300
251,92233,11,34,45,126,330,501,2.195608782,6.786427146,8.982035928,25.1497006,65.86826347,158400
252,92234,24,67,91,121,330,542,4.42804428,12.36162362,16.7896679,22.32472325,60.88560886,325200
253,92236,128,324,452,929,2319,3700,3.459459459,8.756756757,12.21621622,25.10810811,62.67567568,262300
254,92240,12,33,45,45,81,171,7.01754386,19.29824561,26.31578947,26.31578947,47.36842105,230300
255,92243,195,330,525,537,664,1726,11.29779838,19.1193511,30.41714948,31.11239861,38.47045191,216700
256,92249,61,120,181,220,386,787,7.750952986,15.24777637,22.99872935,27.95425667,49.04701398,220200
257,92250,5,31,36,53,33,122,4.098360656,25.40983607,29.50819672,43.44262295,27.04918033,234300
258,92251,88,308,396,627,893,1916,4.592901879,16.07515658,20.66805846,32.72442589,46.60751566,271600
259,92252,4,11,15,32,95,142,2.816901408,7.746478873,10.56338028,22.53521127,66.90140845,217900
260,92253,44,113,157,178,234,569,7.732864675,19.85940246,27.59226714,31.28295255,41.12478032,453600
261,92254,20,59,79,184,680,943,2.120890774,6.256627784,8.377518558,19.51219512,72.11028632,160400
262,92257,0,2,2,5,22,29,0,6.896551724,6.896551724,17.24137931,75.86206897,57800
263,92260,148,198,346,213,191,750,19.73333333,26.4,46.13333333,28.4,25.46666667,363400
264,92262,28,69,97,88,142,327,8.562691131,21.10091743,29.66360856,26.91131498,43.42507645,447800
265,92264,2,6,8,2,25,35,5.714285714,17.14285714,22.85714286,5.714285714,71.42857143,386800
266,92270,12,34,46,82,183,311,3.8585209,10.93247588,14.79099678,26.36655949,58.84244373,570400
267,92273,6,22,28,51,168,247,2.429149798,8.906882591,11.33603239,20.64777328,68.01619433,158800
268,92274,62,206,268,534,1415,2217,2.796571944,9.291835814,12.08840776,24.08660352,63.82498872,113200
269,92275,4,25,29,63,296,388,1.030927835,6.443298969,7.474226804,16.2371134,76.28865979,145600
270,92277,27,41,68,67,148,283,9.540636042,14.48763251,24.02826855,23.67491166,52.29681979,158900
271,92281,3,24,27,45,157,229,1.310043668,10.48034934,11.79039301,19.65065502,68.55895197,160600
272,92284,21,45,66,135,344,545,3.853211009,8.256880734,12.11009174,24.7706422,63.11926606,225100
273,92301,20,23,43,79,121,243,8.230452675,9.465020576,17.69547325,32.51028807,49.79423868,238600
274,92307,14,25,39,30,30,99,14.14141414,25.25252525,39.39393939,30.3030303,30.3030303,301700
275,92309,3,6,9,13,37,59,5.084745763,10.16949153,15.25423729,22.03389831,62.71186441,86300
276,92311,66,217,283,543,1732,2558,2.580140735,8.483189992,11.06333073,21.2275215,67.70914777,144900
277,92313,44,94,138,189,399,726,6.060606061,12.9476584,19.00826446,26.03305785,54.95867769,378100
278,92314,28,45,73,51,95,219,12.78538813,20.54794521,33.33333333,23.28767123,43.37899543,307100
279,92315,69,105,174,235,338,747,9.236947791,14.0562249,23.29317269,31.45917001,45.2476573,467800
280,92316,73,184,257,355,959,1571,4.646721833,11.71228517,16.359007,22.59707193,61.04392107,339100
281,92324,37,116,153,283,737,1173,3.1543052,9.889173061,13.04347826,24.12617221,62.83034953,326000
282,92327,4,9,13,22,30,65,6.153846154,13.84615385,20,33.84615385,46.15384615,151700
283,92337,2,8,10,71,287,368,0.543478261,2.173913043,2.717391304,19.29347826,77.98913043,403600
284,92339,12,11,23,19,4,46,26.08695652,23.91304348,50,41.30434783,8.695652174,335700
285,92342,34,95,129,188,253,570,5.964912281,16.66666667,22.63157895,32.98245614,44.38596491,266100
286,92344,21,66,87,105,238,430,4.88372093,15.34883721,20.23255814,24.41860465,55.34883721,345700
287,92345,102,312,414,600,1339,2353,4.334891628,13.25966851,17.59456014,25.49936252,56.90607735,277100
288,92346,3,33,36,86,321,443,0.677200903,7.449209932,8.126410835,19.41309255,72.46049661,367300
289,92352,30,53,83,162,393,638,4.702194357,8.307210031,13.00940439,25.39184953,61.59874608,457800
290,92356,118,214,332,409,673,1414,8.345120226,15.13437058,23.47949081,28.92503536,47.59547383,169100
291,92363,0,12,12,22,78,112,0,10.71428571,10.71428571,19.64285714,69.64285714,125400
292,92365,6,8,14,11,16,41,14.63414634,19.51219512,34.14634146,26.82926829,39.02439024,117600
293,92368,1,8,9,20,62,91,1.098901099,8.791208791,9.89010989,21.97802198,68.13186813,259800
294,92376,30,153,183,240,398,821,3.65408039,18.63580999,22.28989038,29.23264312,48.4774665,332100
295,92377,39,75,114,111,137,362,10.77348066,20.71823204,31.49171271,30.66298343,37.84530387,418300
296,92391,0,5,5,14,92,111,0,4.504504505,4.504504505,12.61261261,82.88288288,277100
297,92399,232,267,499,250,206,955,24.29319372,27.95811518,52.2513089,26.17801047,21.57068063,368400
298,92404,10,21,31,48,172,251,3.984063745,8.366533865,12.35059761,19.12350598,68.52589641,289900
299,92405,5,9,14,15,6,35,14.28571429,25.71428571,40,42.85714286,17.14285714,277800
300,92410,16,37,53,64,84,201,7.960199005,18.4079602,26.3681592,31.84079602,41.79104478,207500
301,92501,0,3,3,11,192,206,0,1.45631068,1.45631068,5.339805825,93.2038835,358700
302,92530,16,39,55,65,116,236,6.779661017,16.52542373,23.30508475,27.54237288,49.15254237,368200
303,92532,28,46,74,37,41,152,18.42105263,30.26315789,48.68421053,24.34210526,26.97368421,413400
304,92539,4,8,12,24,24,60,6.666666667,13.33333333,20,40,40,242300
305,92543,29,23,52,28,62,142,20.42253521,16.1971831,36.61971831,19.71830986,43.66197183,169000
306,92544,15,48,63,105,163,331,4.531722054,14.50151057,19.03323263,31.72205438,49.24471299,271700
307,92545,17,69,86,140,293,519,3.275529865,13.29479769,16.57032755,26.97495183,56.45472062,252000
308,92553,7,33,40,70,184,294,2.380952381,11.2244898,13.60544218,23.80952381,62.58503401,321800
309,92562,7,12,19,10,20,49,14.28571429,24.48979592,38.7755102,20.40816327,40.81632653,478500
310,92567,27,44,71,46,37,154,17.53246753,28.57142857,46.1038961,29.87012987,24.02597403,379400
311,92570,28,122,150,283,669,1102,2.540834846,11.0707804,13.61161525,25.68058076,60.70780399,326200
312,92571,8,29,37,66,75,178,4.494382022,16.29213483,20.78651685,37.07865169,42.13483146,336100
313,92583,72,216,288,411,629,1328,5.421686747,16.26506024,21.68674699,30.94879518,47.36445783,251700
314,92584,59,116,175,120,137,432,13.65740741,26.85185185,40.50925926,27.77777778,31.71296296,422000
315,92585,20,74,94,143,211,448,4.464285714,16.51785714,20.98214286,31.91964286,47.09821429,371400
316,92590,98,101,199,127,167,493,19.87829615,20.48681542,40.36511156,25.76064909,33.87423935,1071800
317,92592,47,86,133,127,113,373,12.60053619,23.05630027,35.65683646,34.04825737,30.29490617,522400
318,92595,53,91,144,150,207,501,10.57884232,18.16367265,28.74251497,29.94011976,41.31736527,417300
319,92596,128,168,296,170,113,579,22.10708117,29.01554404,51.12262522,29.36096718,19.5164076,475400
320,92602,279,152,431,107,113,651,42.85714286,23.34869432,66.20583717,16.43625192,17.35791091,933600
321,92604,269,138,407,79,75,561,47.95008913,24.59893048,72.54901961,14.08199643,13.36898396,818400
322,92606,292,196,488,94,119,701,41.65477889,27.96005706,69.61483595,13.40941512,16.97574893,853800
323,92612,217,81,298,34,16,348,62.35632184,23.27586207,85.63218391,9.770114943,4.597701149,789000
324,92618,126,49,175,30,24,229,55.02183406,21.39737991,76.41921397,13.10043668,10.48034934,960800
325,92620,201,81,282,44,51,377,53.31564987,21.48541114,74.80106101,11.67108753,13.52785146,982000
326,92625,132,107,239,73,47,359,36.76880223,29.80501393,66.57381616,20.33426184,13.09192201,2000000
327,92626,469,533,1002,743,896,2641,17.75842484,20.18174934,37.94017418,28.13328285,33.92654298,842500
328,92627,449,557,1006,740,938,2684,16.72876304,20.75260805,37.48137109,27.57078987,34.94783905,842100
329,92629,82,86,168,107,106,381,21.52230971,22.57217848,44.09448819,28.0839895,27.82152231,981600
330,92630,164,137,301,143,106,550,29.81818182,24.90909091,54.72727273,26,19.27272727,694800
331,92646,135,129,264,78,36,378,35.71428571,34.12698413,69.84126984,20.63492063,9.523809524,814900
332,92647,15,18,33,27,37,97,15.46391753,18.55670103,34.02061856,27.83505155,38.1443299,793300
333,92648,163,121,284,68,44,396,41.16161616,30.55555556,71.71717172,17.17171717,11.11111111,985800
334,92649,84,77,161,66,47,274,30.65693431,28.10218978,58.75912409,24.08759124,17.15328467,885000
335,92653,56,63,119,85,102,306,18.30065359,20.58823529,38.88888889,27.77777778,33.33333333,771800
336,92656,226,188,414,201,185,800,28.25,23.5,51.75,25.125,23.125,679300
337,92657,113,66,179,40,16,235,48.08510638,28.08510638,76.17021277,17.0212766,6.808510638,2000000
338,92660,487,392,879,335,348,1562,31.17797695,25.09603073,56.27400768,21.446863,22.27912932,1905400
339,92661,70,50,120,37,17,174,40.22988506,28.73563218,68.96551724,21.26436782,9.770114943,2000000
340,92663,370,366,736,372,406,1514,24.43857332,24.17437252,48.61294584,24.57067371,26.81638045,1590000
341,92673,124,159,283,144,123,550,22.54545455,28.90909091,51.45454545,26.18181818,22.36363636,972200
342,92675,142,150,292,165,239,696,20.40229885,21.55172414,41.95402299,23.70689655,34.33908046,770000
343,92683,280,267,547,201,197,945,29.62962963,28.25396825,57.88359788,21.26984127,20.84656085,651200
344,92688,151,148,299,112,66,477,31.65618449,31.02725367,62.68343816,23.48008386,13.83647799,673400
345,92691,260,201,461,186,214,861,30.19744483,23.34494774,53.54239257,21.60278746,24.85481998,750800
346,92692,232,167,399,160,115,674,34.42136499,24.77744807,59.19881306,23.7388724,17.06231454,795500
347,92701,429,290,719,371,570,1660,25.84337349,17.46987952,43.31325301,22.34939759,34.3373494,521700
348,92703,4,17,21,88,390,499,0.801603206,3.406813627,4.208416834,17.63527054,78.15631263,486000
349,92704,244,477,721,729,1004,2454,9.942950285,19.43765281,29.3806031,29.70660147,40.91279544,534800
350,92705,99,122,221,136,237,594,16.66666667,20.53872054,37.20538721,22.8956229,39.8989899,914900
351,92706,47,90,137,106,89,332,14.15662651,27.10843373,41.26506024,31.92771084,26.80722892,673300
352,92707,23,61,84,154,327,565,4.07079646,10.79646018,14.86725664,27.25663717,57.87610619,539700
353,92708,326,232,558,171,188,917,35.55070883,25.29989095,60.85059978,18.64776445,20.50163577,816900
354,92780,41,104,145,165,303,613,6.688417618,16.96574225,23.65415987,26.91680261,49.42903752,669400
355,92801,56,135,191,265,566,1022,5.479452055,13.20939335,18.6888454,25.9295499,55.3816047,543200
356,92802,37,53,90,168,480,738,5.013550136,7.181571816,12.19512195,22.76422764,65.04065041,577500
357,92804,368,503,871,878,1892,3641,10.10711343,13.81488602,23.92199945,24.11425433,51.96374622,594400
358,92805,61,146,207,384,957,1548,3.940568475,9.431524548,13.37209302,24.80620155,61.82170543,583800
359,92806,43,166,209,373,1057,1639,2.623550946,10.12812691,12.75167785,22.75777913,64.49054301,623300
360,92807,186,208,394,213,228,835,22.2754491,24.91017964,47.18562874,25.50898204,27.30538922,731100
361,92808,341,227,568,311,219,1098,31.0564663,20.67395264,51.73041894,28.32422587,19.94535519,807100
362,92821,334,267,601,311,349,1261,26.48691515,21.17367169,47.66058684,24.6629659,27.67644726,700900
363,92831,379,112,491,84,148,723,52.42047026,15.49100968,67.91147994,11.61825726,20.47026279,676300
364,92832,70,118,188,130,86,404,17.32673267,29.20792079,46.53465347,32.17821782,21.28712871,615300
365,92833,234,134,368,122,88,578,40.48442907,23.183391,63.66782007,21.10726644,15.22491349,686700
366,92840,107,120,227,118,164,509,21.021611,23.57563851,44.59724951,23.1827112,32.22003929,590900
367,92841,44,68,112,115,284,511,8.610567515,13.3072407,21.91780822,22.50489237,55.57729941,609900
368,92843,22,72,94,98,199,391,5.626598465,18.41432225,24.04092072,25.06393862,50.89514066,570200
369,92844,101,128,229,97,133,459,22.0043573,27.88671024,49.89106754,21.1328976,28.97603486,545400
370,92845,78,64,142,83,86,311,25.08038585,20.57877814,45.65916399,26.68810289,27.65273312,668900
371,92861,92,87,179,146,191,516,17.82945736,16.86046512,34.68992248,28.29457364,37.01550388,1287100
372,92867,21,60,81,121,339,541,3.881700555,11.09057301,14.97227357,22.36598891,62.66173752,780900
373,92869,119,127,246,131,143,520,22.88461538,24.42307692,47.30769231,25.19230769,27.5,770700
374,92870,281,210,491,250,273,1014,27.71203156,20.71005917,48.42209073,24.65483235,26.92307692,696700
375,92880,3,3,6,4,13,23,13.04347826,13.04347826,26.08695652,17.39130435,56.52173913,601700
376,92883,15,14,29,15,15,59,25.42372881,23.72881356,49.15254237,25.42372881,25.42372881,538500
377,92886,155,105,260,104,76,440,35.22727273,23.86363636,59.09090909,23.63636364,17.27272727,864700
378,93001,226,257,483,397,805,1685,13.41246291,15.25222552,28.66468843,23.56083086,47.77448071,630400
379,93003,450,579,1029,824,1158,3011,14.94520093,19.22949186,34.17469279,27.36632348,38.45898373,617700
380,93004,118,174,292,237,253,782,15.08951407,22.25063939,37.34015345,30.30690537,32.35294118,608100
381,93010,453,608,1061,798,925,2784,16.27155172,21.83908046,38.11063218,28.6637931,33.22557471,662300
382,93012,555,531,1086,570,584,2240,24.77678571,23.70535714,48.48214286,25.44642857,26.07142857,657700
383,93013,65,131,196,202,331,729,8.916323731,17.96982167,26.8861454,27.70919067,45.40466392,822400
384,93021,569,634,1203,767,842,2812,20.23470839,22.54623044,42.78093883,27.27596017,29.943101,690900
385,93022,22,41,63,56,67,186,11.82795699,22.04301075,33.87096774,30.10752688,36.02150538,610500
386,93023,41,93,134,161,174,469,8.742004264,19.82942431,28.57142857,34.32835821,37.10021322,692700
387,93030,40,105,145,223,466,834,4.79616307,12.58992806,17.38609113,26.73860911,55.87529976,530000
388,93033,55,139,194,243,389,826,6.658595642,16.82808717,23.48668281,29.4188862,47.09443099,442700
389,93036,170,486,656,1046,2243,3945,4.309252218,12.31939163,16.62864385,26.51457541,56.85678074,527700
390,93060,29,62,91,124,255,470,6.170212766,13.19148936,19.36170213,26.38297872,54.25531915,446700
391,93063,368,512,880,702,781,2363,15.57342361,21.66737198,37.2407956,29.70799831,33.05120609,626900
392,93065,1559,2319,3878,3416,5076,12370,12.60307195,18.74696847,31.35004042,27.61519806,41.03476152,642900
393,93066,19,25,44,29,43,116,16.37931034,21.55172414,37.93103448,25,37.06896552,1068500
394,93067,2,7,9,7,2,18,11.11111111,38.88888889,50,38.88888889,11.11111111,1875000
395,93103,5,17,22,38,52,112,4.464285714,15.17857143,19.64285714,33.92857143,46.42857143,1117000
396,93108,208,85,293,27,6,326,63.80368098,26.07361963,89.87730061,8.282208589,1.840490798,2000000
397,93117,3,5,8,6,1,15,20,33.33333333,53.33333333,40,6.666666667,838300
398,93202,14,68,82,145,337,564,2.482269504,12.05673759,14.53900709,25.70921986,59.75177305,187500
399,93203,34,58,92,136,295,523,6.500956023,11.08986616,17.59082218,26.00382409,56.40535373,192800
400,93204,10,54,64,203,740,1007,0.993048659,5.362462761,6.35551142,20.15888779,73.48560079,180200
401,93210,4,26,30,50,115,195,2.051282051,13.33333333,15.38461538,25.64102564,58.97435897,203100
402,93212,38,167,205,434,1043,1682,2.25921522,9.928656361,12.18787158,25.80261593,62.00951249,176400
403,93215,199,342,541,521,788,1850,10.75675676,18.48648649,29.24324324,28.16216216,42.59459459,215100
404,93219,13,37,50,109,437,596,2.181208054,6.208053691,8.389261745,18.2885906,73.32214765,162500
405,93223,23,79,102,223,857,1182,1.945854484,6.68358714,8.629441624,18.86632826,72.50423012,189100
406,93224,6,7,13,24,18,55,10.90909091,12.72727273,23.63636364,43.63636364,32.72727273,152200
407,93230,493,838,1331,1238,1751,4320,11.41203704,19.39814815,30.81018519,28.65740741,40.53240741,252300
408,93235,14,61,75,86,166,327,4.281345566,18.65443425,22.93577982,26.29969419,50.76452599,175600
409,93242,3,32,35,63,232,330,0.909090909,9.696969697,10.60606061,19.09090909,70.3030303,264100
410,93243,3,26,29,57,152,238,1.260504202,10.92436975,12.18487395,23.94957983,63.86554622,359400
411,93244,20,44,64,57,92,213,9.389671362,20.657277,30.04694836,26.76056338,43.19248826,177800
412,93245,425,624,1049,853,1022,2924,14.53488372,21.34062927,35.875513,29.17236662,34.95212038,261400
413,93249,17,48,65,124,230,419,4.057279236,11.45584726,15.51312649,29.59427208,54.89260143,149100
414,93250,54,160,214,412,1149,1775,3.042253521,9.014084507,12.05633803,23.21126761,64.73239437,203700
415,93252,571,889,1460,1459,2381,5300,10.77358491,16.77358491,27.54716981,27.52830189,44.9245283,151100
416,93254,3,3,6,18,63,87,3.448275862,3.448275862,6.896551724,20.68965517,72.4137931,182200
417,93256,9,64,73,148,341,562,1.601423488,11.38790036,12.98932384,26.33451957,60.67615658,162700
418,93257,74,257,331,435,1219,1985,3.727959698,12.94710327,16.67506297,21.91435768,61.41057935,211800
419,93261,4,12,16,48,283,347,1.152737752,3.458213256,4.610951009,13.83285303,81.55619597,127600
420,93263,97,254,351,559,1385,2295,4.226579521,11.06753813,15.29411765,24.35729847,60.34858388,206700
421,93265,23,36,59,61,57,177,12.99435028,20.33898305,33.33333333,34.46327684,32.20338983,305900
422,93267,26,100,126,225,539,890,2.921348315,11.23595506,14.15730337,25.28089888,60.56179775,143000
423,93268,3,11,14,39,126,179,1.675977654,6.145251397,7.82122905,21.7877095,70.39106145,164200
424,93270,20,69,89,124,347,560,3.571428571,12.32142857,15.89285714,22.14285714,61.96428571,221700
425,93271,15,24,39,21,22,82,18.29268293,29.26829268,47.56097561,25.6097561,26.82926829,333600
426,93274,290,791,1081,1806,4364,7251,3.999448352,10.90884016,14.90828851,24.90690939,60.1848021,246600
427,93277,56,60,116,108,163,387,14.47028424,15.50387597,29.97416021,27.90697674,42.11886305,256600
428,93280,20,74,94,137,458,689,2.90275762,10.74020319,13.64296081,19.8838897,66.47314949,188300
429,93286,26,89,115,191,550,856,3.037383178,10.39719626,13.43457944,22.31308411,64.25233645,232800
430,93287,0,3,3,5,5,13,0,23.07692308,23.07692308,38.46153846,38.46153846,221900
431,93291,66,108,174,109,138,421,15.67695962,25.65320665,41.33016627,25.89073634,32.77909739,294800
432,93292,37,54,91,120,272,483,7.660455487,11.18012422,18.84057971,24.8447205,56.31469979,252500
433,93301,2,20,22,75,266,363,0.550964187,5.509641873,6.060606061,20.66115702,73.27823691,190600
434,93308,6,35,41,130,399,570,1.052631579,6.140350877,7.192982456,22.80701754,70,242800
435,93311,22,59,81,154,265,500,4.4,11.8,16.2,30.8,53,324800
436,93313,17,77,94,159,244,497,3.420523139,15.49295775,18.91348089,31.99195171,49.0945674,283400
437,93314,69,127,196,186,226,608,11.34868421,20.88815789,32.23684211,30.59210526,37.17105263,412200
438,93401,181,208,389,204,152,745,24.29530201,27.91946309,52.2147651,27.38255034,20.40268456,775100
439,93402,156,194,350,212,178,740,21.08108108,26.21621622,47.2972973,28.64864865,24.05405405,616100
440,93405,503,366,869,373,418,1660,30.30120482,22.04819277,52.34939759,22.46987952,25.18072289,753500
441,93426,2,3,5,4,4,13,15.38461538,23.07692308,38.46153846,30.76923077,30.76923077,446200
442,93428,22,33,55,74,146,275,8,12,20,26.90909091,53.09090909,705200
443,93430,22,28,50,26,28,104,21.15384615,26.92307692,48.07692308,25,26.92307692,896700
444,93434,20,62,82,200,515,797,2.509410289,7.779171895,10.28858218,25.09410289,64.61731493,337100
445,93436,7,4,11,5,3,19,36.84210526,21.05263158,57.89473684,26.31578947,15.78947368,373600
446,93441,35,36,71,13,13,97,36.08247423,37.11340206,73.19587629,13.40206186,13.40206186,927500
447,93442,38,72,110,79,100,289,13.14878893,24.91349481,38.06228374,27.33564014,34.60207612,711900
448,93446,62,74,136,117,218,471,13.16348195,15.71125265,28.87473461,24.84076433,46.28450106,502500
449,93451,25,68,93,64,64,221,11.31221719,30.76923077,42.08144796,28.95927602,28.95927602,427400
450,93455,23,35,58,36,24,118,19.49152542,29.66101695,49.15254237,30.50847458,20.33898305,452600
451,93460,11,40,51,80,79,210,5.238095238,19.04761905,24.28571429,38.0952381,37.61904762,962500
452,93463,68,89,157,98,86,341,19.94134897,26.09970674,46.04105572,28.73900293,25.21994135,892900
453,93465,27,45,72,55,62,189,14.28571429,23.80952381,38.0952381,29.1005291,32.8042328,763200
454,93510,10,12,22,23,63,108,9.259259259,11.11111111,20.37037037,21.2962963,58.33333333,589000
455,93513,4,9,13,21,48,82,4.87804878,10.97560976,15.85365854,25.6097561,58.53658537,269600
456,93514,100,153,253,270,426,949,10.5374078,16.12223393,26.65964173,28.45100105,44.88935722,337700
457,93516,6,17,23,49,121,193,3.10880829,8.808290155,11.91709845,25.38860104,62.69430052,74500
458,93517,8,5,13,8,10,31,25.80645161,16.12903226,41.93548387,25.80645161,32.25806452,254200
459,93518,2,2,4,5,16,25,8,8,16,20,64,235800
460,93523,48,87,135,178,225,538,8.921933086,16.17100372,25.0929368,33.08550186,41.82156134,81200
461,93527,2,13,15,35,57,107,1.869158879,12.14953271,14.01869159,32.71028037,53.27102804,212100
462,93532,9,19,28,35,27,90,10,21.11111111,31.11111111,38.88888889,30,318700
463,93534,4,18,22,51,157,230,1.739130435,7.826086957,9.565217391,22.17391304,68.26086957,257600
464,93535,6,15,21,85,457,563,1.065719361,2.664298401,3.730017762,15.09769094,81.1722913,241800
465,93541,11,19,30,18,21,69,15.94202899,27.53623188,43.47826087,26.08695652,30.43478261,216300
466,93545,13,37,50,52,63,165,7.878787879,22.42424242,30.3030303,31.51515152,38.18181818,197600
467,93546,8,11,19,20,29,68,11.76470588,16.17647059,27.94117647,29.41176471,42.64705882,493800
468,93550,9,23,32,77,341,450,2,5.111111111,7.111111111,17.11111111,75.77777778,280900
469,93555,230,375,605,654,1129,2388,9.631490787,15.70351759,25.33500838,27.38693467,47.27805695,194600
470,93561,106,250,356,388,641,1385,7.653429603,18.05054152,25.70397112,28.01444043,46.28158845,295000
471,93562,6,6,12,25,79,116,5.172413793,5.172413793,10.34482759,21.55172414,68.10344828,57600
472,93601,12,37,49,61,57,167,7.185628743,22.15568862,29.34131737,36.52694611,34.13173653,327800
473,93602,11,16,27,17,13,57,19.29824561,28.07017544,47.36842105,29.8245614,22.80701754,291300
474,93608,3,12,15,28,66,109,2.752293578,11.00917431,13.76146789,25.68807339,60.55045872,154600
475,93609,50,114,164,201,433,798,6.26566416,14.28571429,20.55137845,25.18796992,54.26065163,206000
476,93610,46,85,131,141,128,400,11.5,21.25,32.75,35.25,32,250600
477,93614,20,36,56,102,195,353,5.66572238,10.19830028,15.86402266,28.89518414,55.2407932,307300
478,93615,12,30,42,69,206,317,3.785488959,9.463722397,13.24921136,21.76656151,64.98422713,171900
479,93618,61,123,184,241,402,827,7.376058041,14.87303507,22.24909311,29.14147521,48.60943168,237000
480,93620,24,89,113,264,622,999,2.402402402,8.908908909,11.31131131,26.42642643,62.26226226,267700
481,93622,28,119,147,325,716,1188,2.356902357,10.01683502,12.37373737,27.35690236,60.26936027,185900
482,93625,112,227,339,356,534,1229,9.113100081,18.47030106,27.58340114,28.96663954,43.44995932,298100
483,93630,162,376,538,806,1310,2654,6.103993971,14.16729465,20.27128862,30.36925396,49.35945742,262200
484,93631,308,406,714,600,776,2090,14.73684211,19.42583732,34.16267943,28.70813397,37.1291866,326800
485,93635,0,6,6,35,199,240,0,2.5,2.5,14.58333333,82.91666667,343000
486,93636,130,264,394,316,326,1036,12.54826255,25.48262548,38.03088803,30.5019305,31.46718147,375000
487,93637,0,0,0,3,11,14,0,0,0,21.42857143,78.57142857,275900
488,93638,33,16,49,30,99,178,18.53932584,8.988764045,27.52808989,16.85393258,55.61797753,239700
489,93640,67,147,214,420,1166,1800,3.722222222,8.166666667,11.88888889,23.33333333,64.77777778,204600
490,93644,35,84,119,106,176,401,8.728179551,20.94763092,29.67581047,26.43391521,43.89027431,301300
491,93646,64,178,242,367,716,1325,4.830188679,13.43396226,18.26415094,27.69811321,54.03773585,201700
492,93647,75,183,258,430,989,1677,4.472271914,10.91234347,15.38461538,25.64102564,58.97435897,167400
493,93648,64,171,235,371,1263,1869,3.424291065,9.149277689,12.57356875,19.85018727,67.57624398,186100
494,93651,34,69,103,90,78,271,12.54612546,25.46125461,38.00738007,33.2103321,28.78228782,366400
495,93652,0,5,5,29,151,185,0,2.702702703,2.702702703,15.67567568,81.62162162,169900
496,93653,3,12,15,16,12,43,6.976744186,27.90697674,34.88372093,37.20930233,27.90697674,443500
497,93654,279,555,834,859,1395,3088,9.034974093,17.97279793,27.00777202,27.81735751,45.17487047,250200
498,93656,32,113,145,208,404,757,4.227212682,14.92734478,19.15455746,27.47688243,53.36856011,208200
499,93657,38,112,150,170,329,649,5.855161787,17.25731895,23.11248074,26.19414484,50.69337442,307100
500,93660,7,26,33,69,278,380,1.842105263,6.842105263,8.684210526,18.15789474,73.15789474,207900
501,93662,11,46,57,78,128,263,4.182509506,17.4904943,21.6730038,29.65779468,48.66920152,216900
502,93667,20,50,70,98,117,285,7.01754386,17.54385965,24.56140351,34.38596491,41.05263158,283300
503,93668,1,16,17,42,119,178,0.561797753,8.988764045,9.550561798,23.59550562,66.85393258,370600
504,93673,5,22,27,34,70,131,3.816793893,16.79389313,20.61068702,25.95419847,53.4351145,176100
505,93701,0,0,0,4,19,23,0,0,0,17.39130435,82.60869565,164100
506,93702,4,37,41,75,182,298,1.342281879,12.41610738,13.75838926,25.16778523,61.0738255,159800
507,93703,19,31,50,80,281,411,4.622871046,7.542579075,12.16545012,19.46472019,68.36982968,183200
508,93704,37,119,156,215,466,837,4.420549582,14.21744325,18.63799283,25.6869773,55.67502987,291600
509,93705,13,34,47,58,106,211,6.161137441,16.11374408,22.27488152,27.48815166,50.23696682,213400
510,93706,154,341,495,806,2087,3388,4.545454545,10.06493506,14.61038961,23.78984652,61.59976387,186300
511,93710,8,25,33,64,147,244,3.278688525,10.24590164,13.52459016,26.2295082,60.24590164,281800
512,93721,11,24,35,45,194,274,4.01459854,8.759124088,12.77372263,16.42335766,70.80291971,181500
513,93722,22,94,116,201,329,646,3.405572755,14.55108359,17.95665635,31.11455108,50.92879257,270900
514,93725,10,15,25,33,86,144,6.944444444,10.41666667,17.36111111,22.91666667,59.72222222,226200
515,93726,9,48,57,151,524,732,1.229508197,6.557377049,7.786885246,20.6284153,71.58469945,214600
516,93727,13,46,59,153,315,527,2.466793169,8.728652751,11.19544592,29.03225806,59.77229602,287000
517,93907,0,13,13,31,55,99,0,13.13131313,13.13131313,31.31313131,55.55555556,566800
518,93908,44,87,131,104,71,306,14.37908497,28.43137255,42.81045752,33.9869281,23.20261438,846200
519,93920,2,6,8,8,4,20,10,30,40,40,20,1081500
520,93923,117,103,220,85,44,349,33.5243553,29.51289398,63.03724928,24.35530086,12.60744986,1199000
521,93924,66,72,138,56,32,226,29.20353982,31.85840708,61.0619469,24.77876106,14.15929204,987100
522,93926,15,61,76,125,323,524,2.86259542,11.64122137,14.50381679,23.85496183,61.64122137,453700
523,93927,7,30,37,51,191,279,2.508960573,10.75268817,13.26164875,18.27956989,68.45878136,350400
524,93930,2,30,32,82,181,295,0.677966102,10.16949153,10.84745763,27.79661017,61.3559322,336200
525,93940,39,45,84,74,99,257,15.17509728,17.50972763,32.6848249,28.79377432,38.52140078,861000
526,93950,29,50,79,93,75,247,11.74089069,20.24291498,31.98380567,37.65182186,30.36437247,929200
527,93954,1,6,7,14,22,43,2.325581395,13.95348837,16.27906977,32.55813953,51.1627907,230800
528,93955,30,60,90,106,86,282,10.63829787,21.27659574,31.91489362,37.58865248,30.4964539,588100
529,93962,34,88,122,82,82,286,11.88811189,30.76923077,42.65734266,28.67132867,28.67132867,562500
530,94002,1017,465,1482,306,210,1998,50.9009009,23.27327327,74.17417417,15.31531532,10.51051051,1678500
531,94005,27,30,57,20,20,97,27.83505155,30.92783505,58.7628866,20.6185567,20.6185567,923800
532,94010,1517,675,2192,444,327,2963,51.19811002,22.78096524,73.97907526,14.98481269,11.03611205,2000000
533,94014,91,179,270,330,518,1118,8.139534884,16.01073345,24.15026834,29.51699463,46.33273703,865400
534,94015,303,465,768,583,749,2100,14.42857143,22.14285714,36.57142857,27.76190476,35.66666667,932200
535,94022,737,177,914,90,70,1074,68.62197393,16.48044693,85.10242086,8.379888268,6.517690875,2000000
536,94024,106,52,158,23,12,193,54.92227979,26.94300518,81.86528497,11.91709845,6.21761658,2000000
537,94025,365,113,478,147,257,882,41.38321995,12.81179138,54.19501134,16.66666667,29.138322,2000000
538,94027,54,30,84,12,2,98,55.10204082,30.6122449,85.71428571,12.24489796,2.040816327,2000000
539,94028,181,62,243,41,24,308,58.76623377,20.12987013,78.8961039,13.31168831,7.792207792,2000000
540,94030,468,296,764,242,223,1229,38.07973963,24.08462164,62.16436127,19.69080553,18.1448332,1606700
541,94040,195,53,248,33,19,300,65,17.66666667,82.66666667,11,6.333333333,2000000
542,94044,293,401,694,390,366,1450,20.20689655,27.65517241,47.86206897,26.89655172,25.24137931,1012200
543,94062,129,62,191,33,16,240,53.75,25.83333333,79.58333333,13.75,6.666666667,2000000
544,94063,53,94,147,174,319,640,8.28125,14.6875,22.96875,27.1875,49.84375,1002400
545,94065,324,123,447,81,57,585,55.38461538,21.02564103,76.41025641,13.84615385,9.743589744,1545800
546,94066,244,326,570,441,607,1618,15.08034611,20.14833127,35.22867738,27.25587145,37.51545117,1027400
547,94070,890,498,1388,360,250,1998,44.54454454,24.92492492,69.46946947,18.01801802,12.51251251,1910300
548,94080,475,551,1026,750,1091,2867,16.56784095,19.2186955,35.78653645,26.15974887,38.05371468,963700
549,94087,1129,411,1540,274,208,2022,55.83580613,20.3264095,76.16221563,13.55093966,10.28684471,1945100
550,94110,39,63,102,83,71,256,15.234375,24.609375,39.84375,32.421875,27.734375,1233600
551,94112,4,12,16,9,25,50,8,24,32,18,50,1022100
552,94115,64,83,147,145,174,466,13.73390558,17.8111588,31.54506438,31.11587983,37.33905579,1515600
553,94121,9,4,13,1,2,16,56.25,25,81.25,6.25,12.5,1506400
554,94124,18,51,69,100,166,335,5.373134328,15.2238806,20.59701493,29.85074627,49.55223881,873900
555,94127,10,3,13,9,0,22,45.45454545,13.63636364,59.09090909,40.90909091,0,1572100
556,94301,244,95,339,76,30,445,54.83146067,21.34831461,76.17977528,17.07865169,6.741573034,2000000
557,94303,785,312,1097,193,167,1457,53.87783116,21.4138641,75.29169526,13.24639671,11.46190803,1567000
558,94305,223,82,305,56,41,402,55.47263682,20.39800995,75.87064677,13.93034826,10.19900498,2000000
559,94306,1544,434,1978,253,185,2416,63.90728477,17.96357616,81.87086093,10.4718543,7.657284768,2000000
560,94401,184,120,304,133,155,592,31.08108108,20.27027027,51.35135135,22.46621622,26.18243243,944300
561,94402,462,362,824,456,628,1908,24.21383648,18.97274633,43.18658281,23.89937107,32.91404612,1882300
562,94403,385,333,718,523,963,2204,17.46823956,15.10889292,32.57713249,23.72958258,43.69328494,1499300
563,94404,981,415,1396,288,191,1875,52.32,22.13333333,74.45333333,15.36,10.18666667,1404600
564,94503,127,86,213,113,122,448,28.34821429,19.19642857,47.54464286,25.22321429,27.23214286,557800
565,94508,5,3,8,3,2,13,38.46153846,23.07692308,61.53846154,23.07692308,15.38461538,684400
566,94509,23,36,59,67,128,254,9.05511811,14.17322835,23.22834646,26.37795276,50.39370079,435600
567,94510,5,4,9,2,2,13,38.46153846,30.76923077,69.23076923,15.38461538,15.38461538,628300
568,94514,0,1,1,5,7,13,0,7.692307692,7.692307692,38.46153846,53.84615385,711000
569,94516,6,2,8,12,6,26,23.07692308,7.692307692,30.76923077,46.15384615,23.07692308,685500
570,94517,185,210,395,214,165,774,23.90180879,27.13178295,51.03359173,27.64857881,21.31782946,815600
571,94518,43,117,160,265,737,1162,3.700516351,10.06884682,13.76936317,22.80550775,63.42512909,649100
572,94519,55,119,174,139,249,562,9.786476868,21.17437722,30.96085409,24.73309609,44.30604982,608400
573,94520,26,78,104,218,536,858,3.03030303,9.090909091,12.12121212,25.40792541,62.47086247,480300
574,94521,232,338,570,556,900,2026,11.45113524,16.68311945,28.13425469,27.44323791,44.4225074,649100
575,94523,673,739,1412,739,725,2876,23.40055633,25.69541029,49.09596662,25.69541029,25.20862309,827200
576,94526,5,5,10,4,1,15,33.33333333,33.33333333,66.66666667,26.66666667,6.666666667,1265000
577,94531,35,75,110,96,109,315,11.11111111,23.80952381,34.92063492,30.47619048,34.6031746,528200
578,94533,49,99,148,186,528,862,5.684454756,11.48491879,17.16937355,21.57772622,61.25290023,393700
579,94534,40,114,154,119,184,457,8.75273523,24.9452954,33.69803063,26.03938731,40.26258206,589000
580,94536,536,204,740,124,147,1011,53.01681503,20.17804154,73.19485658,12.26508408,14.54005935,989600
581,94538,400,171,571,133,124,828,48.30917874,20.65217391,68.96135266,16.06280193,14.97584541,888400
582,94539,415,63,478,19,13,510,81.37254902,12.35294118,93.7254902,3.725490196,2.549019608,1548800
583,94541,26,54,80,92,177,349,7.449856734,15.47277937,22.9226361,26.36103152,50.71633238,641200
584,94544,0,0,0,3,17,20,0,0,0,15,85,624800
585,94545,60,97,157,152,251,560,10.71428571,17.32142857,28.03571429,27.14285714,44.82142857,664400
586,94546,489,470,959,384,316,1659,29.4755877,28.33031947,57.80590717,23.14647378,19.04761905,811300
587,94549,1130,623,1753,389,145,2287,49.40970704,27.24092698,76.65063402,17.00918233,6.340183647,1547800
588,94550,894,854,1748,863,869,3480,25.68965517,24.54022989,50.22988506,24.79885057,24.97126437,925400
589,94551,445,477,922,613,741,2276,19.55184534,20.95782074,40.50966608,26.93321617,32.55711775,774200
590,94552,223,138,361,119,69,549,40.61930783,25.13661202,65.75591985,21.67577413,12.56830601,1056100
591,94553,109,123,232,144,156,532,20.4887218,23.12030075,43.60902256,27.06766917,29.32330827,628400
592,94556,167,66,233,28,37,298,56.04026846,22.14765101,78.18791946,9.395973154,12.41610738,1224100
593,94563,114,51,165,23,19,207,55.07246377,24.63768116,79.71014493,11.11111111,9.178743961,1539900
594,94565,74,144,218,321,910,1449,5.106970324,9.937888199,15.04485852,22.15320911,62.80193237,442300
595,94567,1,8,9,11,12,32,3.125,25,28.125,34.375,37.5,383300
596,94574,12,21,33,38,33,104,11.53846154,20.19230769,31.73076923,36.53846154,31.73076923,1295900
597,94580,107,109,216,159,183,558,19.17562724,19.53405018,38.70967742,28.49462366,32.79569892,649600
598,94582,25,11,36,0,0,36,69.44444444,30.55555556,100,0,0,1153600
599,94583,17,5,22,1,1,24,70.83333333,20.83333333,91.66666667,4.166666667,4.166666667,987300
600,94587,179,134,313,189,202,704,25.42613636,19.03409091,44.46022727,26.84659091,28.69318182,860300
601,94589,34,61,95,145,241,481,7.068607069,12.68191268,19.75051975,30.14553015,50.1039501,372000
602,94590,0,3,3,6,17,26,0,11.53846154,11.53846154,23.07692308,65.38461538,381400
603,94591,15,35,50,48,52,150,10,23.33333333,33.33333333,32,34.66666667,482700
604,94596,121,76,197,62,40,299,40.46822742,25.4180602,65.88628763,20.73578595,13.37792642,1081800
605,94598,606,485,1091,404,248,1743,34.767642,27.82558807,62.59323006,23.178428,14.22834194,1050800
606,94601,30,40,70,62,121,253,11.85770751,15.81027668,27.66798419,24.50592885,47.82608696,581800
607,94603,18,33,51,117,258,426,4.225352113,7.746478873,11.97183099,27.46478873,60.56338028,447000
608,94605,82,127,209,198,246,653,12.55742726,19.44869832,32.00612557,30.32159265,37.67228178,695000
609,94607,268,227,495,260,340,1095,24.47488584,20.73059361,45.20547945,23.74429224,31.05022831,640800
610,94608,215,48,263,30,36,329,65.34954407,14.58966565,79.93920973,9.118541033,10.94224924,691300
611,94610,1,10,11,16,24,51,1.960784314,19.60784314,21.56862745,31.37254902,47.05882353,1125700
612,94611,661,290,951,147,60,1158,57.08117444,25.04317789,82.12435233,12.69430052,5.18134715,1199600
613,94612,6,13,19,25,61,105,5.714285714,12.38095238,18.0952381,23.80952381,58.0952381,848500
614,94621,24,87,111,204,478,793,3.026481715,10.97099622,13.99747793,25.72509458,60.27742749,445600
615,94704,30,11,41,11,4,56,53.57142857,19.64285714,73.21428571,19.64285714,7.142857143,787300
616,94706,128,54,182,21,15,218,58.71559633,24.7706422,83.48623853,9.633027523,6.880733945,964500
617,94801,6,13,19,37,75,131,4.580152672,9.923664122,14.50381679,28.24427481,57.2519084,475100
618,94804,0,4,4,14,30,48,0,8.333333333,8.333333333,29.16666667,62.5,526600
619,94806,47,119,166,239,465,870,5.402298851,13.67816092,19.08045977,27.47126437,53.44827586,479200
620,94901,363,443,806,643,1082,2531,14.34215725,17.50296326,31.84512051,25.40497827,42.74990122,1136000
621,94903,87,114,201,198,264,663,13.12217195,17.19457014,30.31674208,29.86425339,39.81900452,940800
622,94920,372,236,608,140,52,800,46.5,29.5,76,17.5,6.5,2000000
623,94924,9,11,20,12,9,41,21.95121951,26.82926829,48.7804878,29.26829268,21.95121951,1119300
624,94925,220,154,374,58,29,461,47.72234273,33.40563991,81.12798265,12.5813449,6.290672451,1372500
625,94928,41,62,103,97,124,324,12.65432099,19.13580247,31.79012346,29.9382716,38.27160494,546100
626,94930,219,211,430,213,143,786,27.86259542,26.84478372,54.70737913,27.09923664,18.19338422,927100
627,94939,366,249,615,171,157,943,38.81230117,26.40509014,65.2173913,18.13361612,16.64899258,1697200
628,94941,101,86,187,65,47,299,33.77926421,28.76254181,62.54180602,21.73913043,15.71906355,1582800
629,94945,160,171,331,195,229,755,21.19205298,22.64900662,43.8410596,25.82781457,30.33112583,909300
630,94946,2,3,5,12,7,24,8.333333333,12.5,20.83333333,50,29.16666667,1736600
631,94947,299,351,650,454,566,1670,17.90419162,21.01796407,38.92215569,27.18562874,33.89221557,851100
632,94949,200,241,441,310,523,1274,15.69858713,18.91679749,34.61538462,24.33281005,41.05180534,829100
633,94952,237,276,513,293,370,1176,20.15306122,23.46938776,43.62244898,24.91496599,31.46258503,866200
634,94954,272,364,636,458,407,1501,18.1212525,24.25049967,42.37175217,30.51299134,27.1152565,661700
635,94956,11,13,24,27,39,90,12.22222222,14.44444444,26.66666667,30,43.33333333,1299500
636,94960,263,199,462,114,93,669,39.31240658,29.74588939,69.05829596,17.04035874,13.90134529,1308500
637,94963,22,21,43,38,22,103,21.3592233,20.38834951,41.74757282,36.89320388,21.3592233,928600
638,94965,1,7,8,12,37,57,1.754385965,12.28070175,14.03508772,21.05263158,64.9122807,1173700
639,94971,2,14,16,40,50,106,1.886792453,13.20754717,15.09433962,37.73584906,47.16981132,845200
640,95004,19,31,50,61,96,207,9.178743961,14.97584541,24.15458937,29.46859903,46.37681159,780500
641,95006,62,38,100,49,44,193,32.12435233,19.68911917,51.8134715,25.38860104,22.79792746,646300
642,95008,108,72,180,54,75,309,34.95145631,23.30097087,58.25242718,17.47572816,24.27184466,1230900
643,95014,3631,840,4471,467,278,5216,69.61273006,16.10429448,85.71702454,8.953220859,5.329754601,2000000
644,95018,28,16,44,32,27,103,27.18446602,15.53398058,42.7184466,31.06796117,26.21359223,657200
645,95023,3,6,9,7,22,38,7.894736842,15.78947368,23.68421053,18.42105263,57.89473684,609800
646,95030,163,88,251,61,29,341,47.80058651,25.80645161,73.60703812,17.88856305,8.504398827,2000000
647,95032,568,332,900,258,134,1292,43.9628483,25.69659443,69.65944272,19.96904025,10.37151703,1726700
648,95033,16,28,44,17,18,79,20.25316456,35.44303797,55.69620253,21.51898734,22.78481013,1160400
649,95035,227,133,360,83,104,547,41.49908592,24.31444241,65.81352834,15.17367459,19.01279707,995200
650,95037,173,126,299,86,39,424,40.80188679,29.71698113,70.51886792,20.28301887,9.198113208,954600
651,95045,12,30,42,85,139,266,4.511278195,11.27819549,15.78947368,31.95488722,52.2556391,726500
652,95051,353,229,582,230,224,1036,34.07335907,22.1042471,56.17760618,22.2007722,21.62162162,1253100
653,95054,9,7,16,13,5,34,26.47058824,20.58823529,47.05882353,38.23529412,14.70588235,1195700
654,95060,109,106,215,72,38,325,33.53846154,32.61538462,66.15384615,22.15384615,11.69230769,971100
655,95062,44,54,98,48,69,215,20.46511628,25.11627907,45.58139535,22.3255814,32.09302326,840100
656,95066,245,211,456,211,173,840,29.16666667,25.11904762,54.28571429,25.11904762,20.5952381,920600
657,95070,1188,366,1554,199,87,1840,64.56521739,19.89130435,84.45652174,10.81521739,4.72826087,2000000
658,95073,9,10,19,4,9,32,28.125,31.25,59.375,12.5,28.125,842800
659,95075,1,6,7,9,22,38,2.631578947,15.78947368,18.42105263,23.68421053,57.89473684,809000
660,95076,2,5,7,3,2,12,16.66666667,41.66666667,58.33333333,25,16.66666667,626100
661,95110,35,84,119,206,418,743,4.710632571,11.30551817,16.01615074,27.72543742,56.25841184,739600
662,95111,177,106,283,158,206,647,27.35703246,16.38330757,43.74034003,24.42040185,31.83925811,661700
663,95112,73,143,216,328,1039,1583,4.611497157,9.033480733,13.64497789,20.72015161,65.6348705,823900
664,95116,36,93,129,199,470,798,4.511278195,11.65413534,16.16541353,24.93734336,58.89724311,687900
665,95117,153,82,235,74,100,409,37.40831296,20.04889976,57.45721271,18.09290954,24.44987775,1141000
666,95118,471,446,917,512,655,2084,22.60076775,21.40115163,44.00191939,24.5681382,31.42994242,1111900
667,95120,1507,723,2230,590,523,3343,45.07927012,21.62728089,66.706551,17.64881843,15.64463057,1546400
668,95121,161,119,280,85,96,461,34.92407809,25.81344902,60.73752711,18.43817787,20.82429501,838900
669,95122,262,285,547,465,660,1672,15.66985646,17.04545455,32.715311,27.81100478,39.47368421,674500
670,95123,211,204,415,225,248,888,23.76126126,22.97297297,46.73423423,25.33783784,27.92792793,889800
671,95124,170,80,250,62,37,349,48.71060172,22.9226361,71.63323782,17.76504298,10.6017192,1259000
672,95125,601,618,1219,773,1118,3110,19.32475884,19.87138264,39.19614148,24.85530547,35.94855305,1300600
673,95126,112,225,337,445,754,1536,7.291666667,14.6484375,21.94010417,28.97135417,49.08854167,1011900
674,95127,44,66,110,104,175,389,11.31105398,16.96658098,28.27763496,26.73521851,44.98714653,806400
675,95128,22,29,51,67,117,235,9.361702128,12.34042553,21.70212766,28.5106383,49.78723404,1054000
676,95129,1707,371,2078,180,113,2371,71.99493884,15.64740616,87.642345,7.591733446,4.765921552,1641700
677,95131,0,2,2,7,62,71,0,2.816901408,2.816901408,9.85915493,87.32394366,976300
678,95132,165,95,260,78,76,414,39.85507246,22.9468599,62.80193237,18.84057971,18.35748792,1072200
679,95133,87,103,190,101,164,455,19.12087912,22.63736264,41.75824176,22.1978022,36.04395604,869200
680,95136,25,47,72,94,162,328,7.62195122,14.32926829,21.95121951,28.65853659,49.3902439,897500
681,95148,301,134,435,77,60,572,52.62237762,23.42657343,76.04895105,13.46153846,10.48951049,998600
682,95202,59,147,206,212,503,921,6.406080347,15.96091205,22.3669924,23.0184582,54.6145494,265400
683,95203,4,40,44,76,72,192,2.083333333,20.83333333,22.91666667,39.58333333,37.5,268100
684,95205,6,21,27,52,154,233,2.575107296,9.012875536,11.58798283,22.31759657,66.0944206,225400
685,95206,50,118,168,333,892,1393,3.589375449,8.470926059,12.06030151,23.90524049,64.034458,291800
686,95207,299,435,734,819,1294,2847,10.50228311,15.27924131,25.78152441,28.76712329,45.4513523,318500
687,95209,379,432,811,690,1598,3099,12.22975153,13.93998064,26.16973217,22.26524685,51.56502097,367400
688,95210,41,109,150,244,691,1085,3.778801843,10.04608295,13.82488479,22.48847926,63.68663594,259000
689,95212,109,249,358,462,834,1654,6.590084643,15.05441354,21.64449819,27.93228537,50.42321644,401500
690,95215,10,32,42,78,207,327,3.058103976,9.785932722,12.8440367,23.85321101,63.30275229,303500
691,95219,300,336,636,488,856,1980,15.15151515,16.96969697,32.12121212,24.64646465,43.23232323,436900
692,95220,44,103,147,154,178,479,9.185803758,21.50313152,30.68893528,32.15031315,37.16075157,642500
693,95223,14,14,28,23,14,65,21.53846154,21.53846154,43.07692308,35.38461538,21.53846154,360600
694,95224,30,38,68,51,54,173,17.34104046,21.96531792,39.30635838,29.47976879,31.21387283,327800
695,95230,4,10,14,12,21,47,8.510638298,21.27659574,29.78723404,25.53191489,44.68085106,591900
696,95237,23,39,62,78,141,281,8.185053381,13.87900356,22.06405694,27.75800712,50.17793594,372700
697,95240,113,283,396,554,1306,2256,5.008865248,12.54432624,17.55319149,24.55673759,57.89007092,352400
698,95242,435,652,1087,948,1644,3679,11.82386518,17.72220712,29.5460723,25.7678717,44.68605599,440100
699,95245,5,10,15,16,40,71,7.042253521,14.08450704,21.12676056,22.53521127,56.33802817,383800
700,95247,12,21,33,33,24,90,13.33333333,23.33333333,36.66666667,36.66666667,26.66666667,357500
701,95249,31,57,88,130,225,443,6.997742664,12.86681716,19.86455982,29.34537246,50.79006772,332300
702,95252,23,81,104,217,425,746,3.08310992,10.85790885,13.94101877,29.08847185,56.97050938,360200
703,95255,0,11,11,12,20,43,0,25.58139535,25.58139535,27.90697674,46.51162791,231500
704,95301,43,128,171,236,445,852,5.046948357,15.02347418,20.07042254,27.69953052,52.23004695,288800
705,95303,17,26,43,72,93,208,8.173076923,12.5,20.67307692,34.61538462,44.71153846,592600
706,95304,135,182,317,362,607,1286,10.49766719,14.15241058,24.65007776,28.14930016,47.20062208,692400
707,95307,9,72,81,142,367,590,1.525423729,12.20338983,13.72881356,24.06779661,62.20338983,313000
708,95310,23,35,58,75,125,258,8.914728682,13.56589147,22.48062016,29.06976744,48.4496124,379500
709,95311,1,2,3,13,22,38,2.631578947,5.263157895,7.894736842,34.21052632,57.89473684,252400
710,95313,10,24,34,56,107,197,5.076142132,12.18274112,17.25888325,28.42639594,54.31472081,494000
711,95315,48,150,198,334,652,1184,4.054054054,12.66891892,16.72297297,28.20945946,55.06756757,273000
712,95316,32,57,89,179,372,640,5,8.90625,13.90625,27.96875,58.125,375000
713,95317,9,19,28,40,36,104,8.653846154,18.26923077,26.92307692,38.46153846,34.61538462,425000
714,95318,6,9,15,12,16,43,13.95348837,20.93023256,34.88372093,27.90697674,37.20930233,241500
715,95319,0,1,1,2,23,26,0,3.846153846,3.846153846,7.692307692,88.46153846,194700
716,95320,113,233,346,382,477,1205,9.377593361,19.33609959,28.71369295,31.70124481,39.58506224,448000
717,95321,2,12,14,34,78,126,1.587301587,9.523809524,11.11111111,26.98412698,61.9047619,330900
718,95323,120,123,243,165,136,544,22.05882353,22.61029412,44.66911765,30.33088235,25,451400
719,95324,5,30,35,26,73,134,3.731343284,22.3880597,26.11940299,19.40298507,54.47761194,313200
720,95326,9,27,36,62,127,225,4,12,16,27.55555556,56.44444444,366500
721,95327,4,27,31,38,114,183,2.18579235,14.75409836,16.93989071,20.76502732,62.29508197,271800
722,95328,42,82,124,112,169,405,10.37037037,20.24691358,30.61728395,27.65432099,41.72839506,306000
723,95329,8,19,27,28,54,109,7.339449541,17.43119266,24.7706422,25.68807339,49.5412844,284400
724,95330,234,374,608,420,493,1521,15.38461538,24.58908613,39.97370151,27.61341223,32.41288626,431400
725,95334,90,254,344,475,1060,1879,4.789781799,13.51782863,18.30761043,25.27940394,56.41298563,246500
726,95336,29,100,129,247,604,980,2.959183673,10.20408163,13.16326531,25.20408163,61.63265306,398100
727,95338,57,97,154,174,240,568,10.03521127,17.07746479,27.11267606,30.63380282,42.25352113,320800
728,95340,0,0,0,5,77,82,0,0,0,6.097560976,93.90243902,300400
729,95341,94,250,344,485,787,1616,5.816831683,15.47029703,21.28712871,30.01237624,48.70049505,232400
730,95348,48,130,178,237,388,803,5.97758406,16.18929016,22.16687422,29.5143213,48.31880448,273400
731,95350,187,421,608,884,2021,3513,5.323085682,11.98405921,17.30714489,25.16367777,57.52917734,309800
732,95351,60,204,264,558,2025,2847,2.10748156,7.165437302,9.272918862,19.5995785,71.12750263,241800
733,95354,79,154,233,266,652,1151,6.863596872,13.37966985,20.24326672,23.11033884,56.64639444,280500
734,95355,252,291,543,431,752,1726,14.60023175,16.85979143,31.46002317,24.97103129,43.56894554,359200
735,95356,141,239,380,323,447,1150,12.26086957,20.7826087,33.04347826,28.08695652,38.86956522,389900
736,95357,10,30,40,40,127,207,4.830917874,14.49275362,19.3236715,19.3236715,61.352657,340300
737,95358,209,341,550,652,1517,2719,7.686649503,12.54137551,20.22802501,23.97940419,55.7925708,319900
738,95360,3,13,16,38,88,142,2.112676056,9.154929577,11.26760563,26.76056338,61.97183099,298300
739,95361,204,441,645,763,948,2356,8.658743633,18.71816638,27.37691002,32.38539898,40.237691,407700
740,95363,17,35,52,64,158,274,6.204379562,12.77372263,18.97810219,23.35766423,57.66423358,360300
741,95365,5,44,49,141,295,485,1.030927835,9.072164948,10.10309278,29.07216495,60.82474227,183900
742,95366,380,386,766,484,420,1670,22.75449102,23.11377246,45.86826347,28.98203593,25.1497006,522100
743,95367,41,125,166,313,669,1148,3.571428571,10.88850174,14.45993031,27.26480836,58.27526132,344800
744,95368,108,201,309,373,583,1265,8.537549407,15.88932806,24.42687747,29.48616601,46.08695652,349000
745,95369,7,12,19,14,17,50,14,24,38,28,34,339200
746,95370,130,219,349,389,480,1218,10.67323481,17.98029557,28.65353038,31.93760263,39.408867,342700
747,95372,39,56,95,105,117,317,12.30283912,17.66561514,29.96845426,33.12302839,36.90851735,317000
748,95376,503,823,1326,1589,3226,6141,8.190848396,13.4017261,21.5925745,25.87526461,52.53216089,454200
749,95377,254,475,729,600,830,2159,11.76470588,22.00092635,33.76563224,27.79064382,38.44372395,594900
750,95379,32,87,119,114,118,351,9.116809117,24.78632479,33.9031339,32.47863248,33.61823362,319000
751,95380,166,373,539,723,1670,2932,5.661664393,12.72169168,18.38335607,24.65893588,56.95770805,319900
752,95382,371,626,997,954,1668,3619,10.25145068,17.29759602,27.5490467,26.36087317,46.09008013,374600
753,95383,26,43,69,47,56,172,15.11627907,25,40.11627907,27.3255814,32.55813953,364200
754,95386,52,120,172,263,502,937,5.549626467,12.80683031,18.35645678,28.06830309,53.57524013,323200
755,95388,88,199,287,374,694,1355,6.494464945,14.68634686,21.18081181,27.60147601,51.21771218,231700
756,95389,7,5,12,3,1,16,43.75,31.25,75,18.75,6.25,699100
757,95391,138,94,232,68,85,385,35.84415584,24.41558442,60.25974026,17.66233766,22.07792208,634300
758,95401,4,21,25,26,44,95,4.210526316,22.10526316,26.31578947,27.36842105,46.31578947,541300
759,95403,54,143,197,172,186,555,9.72972973,25.76576577,35.4954955,30.99099099,33.51351351,588800
760,95404,17,45,62,74,65,201,8.457711443,22.3880597,30.84577114,36.8159204,32.33830846,710100
761,95422,16,39,55,155,454,664,2.409638554,5.873493976,8.28313253,23.34337349,68.37349398,156400
762,95423,0,3,3,16,80,99,0,3.03030303,3.03030303,16.16161616,80.80808081,223600
763,95425,4,12,16,19,28,63,6.349206349,19.04761905,25.3968254,30.15873016,44.44444444,556700
764,95426,6,13,19,21,27,67,8.955223881,19.40298507,28.35820896,31.34328358,40.29850746,260400
765,95428,6,7,13,35,96,144,4.166666667,4.861111111,9.027777778,24.30555556,66.66666667,301300
766,95436,7,7,14,0,16,30,23.33333333,23.33333333,46.66666667,0,53.33333333,578800
767,95437,6,20,26,48,60,134,4.47761194,14.92537313,19.40298507,35.82089552,44.7761194,446400
768,95441,1,3,4,17,43,64,1.5625,4.6875,6.25,26.5625,67.1875,952800
769,95448,8,14,22,29,32,83,9.638554217,16.86746988,26.5060241,34.93975904,38.55421687,919400
770,95451,6,10,16,31,87,134,4.47761194,7.462686567,11.94029851,23.13432836,64.92537313,285000
771,95453,25,55,80,168,339,587,4.258943782,9.36967632,13.6286201,28.62010221,57.75127768,342500
772,95454,5,16,21,30,80,131,3.816793893,12.21374046,16.03053435,22.90076336,61.06870229,371700
773,95457,11,44,55,107,358,520,2.115384615,8.461538462,10.57692308,20.57692308,68.84615385,332800
774,95458,8,22,30,40,89,159,5.031446541,13.83647799,18.86792453,25.1572327,55.97484277,234500
775,95459,2,2,4,6,11,21,9.523809524,9.523809524,19.04761905,28.57142857,52.38095238,539800
776,95460,17,29,46,52,63,161,10.55900621,18.01242236,28.57142857,32.29813665,39.13043478,566400
777,95461,24,60,84,122,189,395,6.075949367,15.18987342,21.26582278,30.88607595,47.84810127,315900
778,95462,2,7,9,17,17,43,4.651162791,16.27906977,20.93023256,39.53488372,39.53488372,562500
779,95465,18,31,49,28,24,101,17.82178218,30.69306931,48.51485149,27.72277228,23.76237624,957300
780,95466,10,18,28,23,43,94,10.63829787,19.14893617,29.78723404,24.46808511,45.74468085,583300
781,95467,15,49,64,52,72,188,7.978723404,26.06382979,34.04255319,27.65957447,38.29787234,338300
782,95468,1,3,4,4,7,15,6.666666667,20,26.66666667,26.66666667,46.66666667,494100
783,95472,80,105,185,105,77,367,21.79836512,28.61035422,50.40871935,28.61035422,20.98092643,890700
784,95476,10,12,22,36,36,94,10.63829787,12.76595745,23.40425532,38.29787234,38.29787234,767900
785,95482,18,35,53,49,107,209,8.612440191,16.74641148,25.35885167,23.44497608,51.19617225,402700
786,95485,14,50,64,99,213,376,3.723404255,13.29787234,17.0212766,26.32978723,56.64893617,299100
787,95490,3,25,28,69,194,291,1.030927835,8.591065292,9.621993127,23.71134021,66.66666667,337600
788,95501,58,108,166,262,556,984,5.894308943,10.97560976,16.8699187,26.62601626,56.50406504,299400
789,95503,129,246,375,405,637,1417,9.103740296,17.36062103,26.46436133,28.58151023,44.95412844,337600
790,95519,7,25,32,29,26,87,8.045977011,28.73563218,36.7816092,33.33333333,29.88505747,352700
791,95521,191,275,466,324,327,1117,17.09937332,24.61951656,41.71888988,29.00626679,29.27484333,379000
792,95524,75,81,156,83,44,283,26.50176678,28.62190813,55.12367491,29.32862191,15.54770318,484900
793,95525,6,17,23,37,49,109,5.504587156,15.59633028,21.10091743,33.94495413,44.95412844,388200
794,95526,2,9,11,6,4,21,9.523809524,42.85714286,52.38095238,28.57142857,19.04761905,262100
795,95527,10,16,26,20,9,55,18.18181818,29.09090909,47.27272727,36.36363636,16.36363636,272700
796,95528,8,21,29,32,15,76,10.52631579,27.63157895,38.15789474,42.10526316,19.73684211,383900
797,95531,22,45,67,71,142,280,7.857142857,16.07142857,23.92857143,25.35714286,50.71428571,236100
798,95536,15,45,60,88,87,235,6.382978723,19.14893617,25.53191489,37.44680851,37.0212766,443500
799,95540,69,116,185,284,481,950,7.263157895,12.21052632,19.47368421,29.89473684,50.63157895,313500
800,95547,20,26,46,40,16,102,19.60784314,25.49019608,45.09803922,39.21568627,15.68627451,470800
801,95549,0,3,3,7,9,19,0,15.78947368,15.78947368,36.84210526,47.36842105,536500
802,95551,0,0,0,8,54,62,0,0,0,12.90322581,87.09677419,391100
803,95555,1,0,1,5,12,18,5.555555556,0,5.555555556,27.77777778,66.66666667,325000
804,95558,3,5,8,4,7,19,15.78947368,26.31578947,42.10526316,21.05263158,36.84210526,708300
805,95562,9,13,22,57,89,168,5.357142857,7.738095238,13.0952381,33.92857143,52.97619048,239000
806,95565,19,34,53,38,36,127,14.96062992,26.77165354,41.73228346,29.92125984,28.34645669,284600
807,95568,0,0,0,4,7,11,0,0,0,36.36363636,63.63636364,326200
808,95570,14,26,40,30,27,97,14.43298969,26.80412371,41.2371134,30.92783505,27.83505155,446600
809,95585,2,3,5,8,18,31,6.451612903,9.677419355,16.12903226,25.80645161,58.06451613,356700
810,95589,3,1,4,12,4,20,15,5,20,60,20,405300
811,95603,236,361,597,526,768,1891,12.48016922,19.09042834,31.57059757,27.81597039,40.61343205,474900
812,95608,349,502,851,687,975,2513,13.88778353,19.97612415,33.86390768,27.33784322,38.7982491,448700
813,95614,24,31,55,44,39,138,17.39130435,22.46376812,39.85507246,31.88405797,28.26086957,430400
814,95616,149,75,224,32,32,288,51.73611111,26.04166667,77.77777778,11.11111111,11.11111111,730800
815,95619,0,2,2,5,16,23,0,8.695652174,8.695652174,21.73913043,69.56521739,277300
816,95620,63,137,200,216,355,771,8.171206226,17.769131,25.94033722,28.0155642,46.04409857,458600
817,95621,0,7,7,12,49,68,0,10.29411765,10.29411765,17.64705882,72.05882353,327900
818,95623,31,55,86,64,105,255,12.15686275,21.56862745,33.7254902,25.09803922,41.17647059,443500
819,95624,1563,1812,3375,2022,2053,7450,20.97986577,24.32214765,45.30201342,27.1409396,27.55704698,473300
820,95627,6,33,39,112,234,385,1.558441558,8.571428571,10.12987013,29.09090909,60.77922078,357900
821,95628,109,143,252,140,139,531,20.52730697,26.93032015,47.45762712,26.3653484,26.17702448,489000
822,95631,34,59,93,86,99,278,12.23021583,21.22302158,33.45323741,30.9352518,35.61151079,409400
823,95633,5,31,36,69,106,211,2.369668246,14.69194313,17.06161137,32.7014218,50.23696682,341700
824,95634,14,38,52,67,95,214,6.542056075,17.75700935,24.29906542,31.30841121,44.39252336,323700
825,95640,11,31,42,74,82,198,5.555555556,15.65656566,21.21212121,37.37373737,41.41414141,345100
826,95642,90,184,274,337,541,1152,7.8125,15.97222222,23.78472222,29.25347222,46.96180556,348900
827,95648,816,1115,1931,1588,1583,5102,15.99372795,21.85417483,37.84790278,31.125049,31.02704822,514000
828,95650,80,109,189,112,79,380,21.05263158,28.68421053,49.73684211,29.47368421,20.78947368,682700
829,95655,1,0,1,0,14,15,6.666666667,0,6.666666667,0,93.33333333,433100
830,95658,66,77,143,56,47,246,26.82926829,31.30081301,58.1300813,22.76422764,19.10569106,702600
831,95659,53,46,99,84,62,245,21.63265306,18.7755102,40.40816327,34.28571429,25.30612245,435700
832,95660,0,0,0,1,10,11,0,0,0,9.090909091,90.90909091,256000
833,95661,392,402,794,423,299,1516,25.85751979,26.5171504,52.37467018,27.90237467,19.72295515,550300
834,95662,11,5,16,9,2,27,40.74074074,18.51851852,59.25925926,33.33333333,7.407407407,408300
835,95666,5,12,17,37,34,88,5.681818182,13.63636364,19.31818182,42.04545455,38.63636364,288400
836,95667,191,355,546,517,697,1760,10.85227273,20.17045455,31.02272727,29.375,39.60227273,434200
837,95668,12,24,36,44,28,108,11.11111111,22.22222222,33.33333333,40.74074074,25.92592593,480000
838,95669,6,17,23,23,47,93,6.451612903,18.27956989,24.7311828,24.7311828,50.53763441,459000
839,95672,218,207,425,194,171,790,27.59493671,26.20253165,53.79746835,24.55696203,21.64556962,573400
840,95674,4,13,17,26,30,73,5.479452055,17.80821918,23.28767123,35.61643836,41.09589041,456300
841,95678,186,301,487,368,412,1267,14.68034728,23.75690608,38.43725335,29.04498816,32.51775848,426500
842,95681,1,5,6,7,13,26,3.846153846,19.23076923,23.07692308,26.92307692,50,312700
843,95682,67,67,134,46,22,202,33.16831683,33.16831683,66.33663366,22.77227723,10.89108911,544400
844,95683,50,51,101,63,33,197,25.38071066,25.88832487,51.26903553,31.97969543,16.75126904,550800
845,95684,13,28,41,67,60,168,7.738095238,16.66666667,24.4047619,39.88095238,35.71428571,460700
846,95685,30,42,72,83,139,294,10.20408163,14.28571429,24.48979592,28.23129252,47.27891156,447400
847,95686,4,10,14,41,53,108,3.703703704,9.259259259,12.96296296,37.96296296,49.07407407,311000
848,95688,52,83,135,128,88,351,14.81481481,23.64672365,38.46153846,36.46723647,25.07122507,563300
849,95691,90,123,213,168,217,598,15.05016722,20.56856187,35.6187291,28.09364548,36.28762542,412100
850,95692,55,124,179,209,211,599,9.18196995,20.70116861,29.88313856,34.89148581,35.22537563,310900
851,95693,52,65,117,59,59,235,22.12765957,27.65957447,49.78723404,25.10638298,25.10638298,657600
852,95694,5,12,17,23,56,96,5.208333333,12.5,17.70833333,23.95833333,58.33333333,474000
853,95695,8,37,45,52,97,194,4.12371134,19.07216495,23.19587629,26.80412371,50,402800
854,95701,6,26,32,13,16,61,9.836065574,42.62295082,52.45901639,21.31147541,26.2295082,460400
855,95709,26,59,85,86,97,268,9.701492537,22.01492537,31.71641791,32.08955224,36.19402985,465300
856,95713,43,63,106,118,138,362,11.87845304,17.40331492,29.28176796,32.59668508,38.12154696,422400
857,95720,3,2,5,6,4,15,20,13.33333333,33.33333333,40,26.66666667,365000
858,95726,38,74,112,121,146,379,10.02638522,19.52506596,29.55145119,31.92612137,38.52242744,341300
859,95742,274,255,529,168,126,823,33.29283111,30.98420413,64.27703524,20.41312272,15.30984204,472200
860,95746,627,410,1037,353,199,1589,39.45877911,25.80239144,65.26117055,22.2152297,12.52359975,852900
861,95747,582,748,1330,873,719,2922,19.91786448,25.59890486,45.51676934,29.87679671,24.60643395,537300
862,95757,1760,1665,3425,1481,1267,6173,28.51125871,26.97229872,55.48355743,23.99157622,20.52486635,507100
863,95758,641,831,1472,1091,1249,3812,16.81532004,21.79958027,38.61490031,28.6201469,32.76495278,434500
864,95762,704,679,1383,569,351,2303,30.56882327,29.48328267,60.05210595,24.70690404,15.24099001,699100
865,95765,244,369,613,377,353,1343,18.16827997,27.47580045,45.64408042,28.07148176,26.28443783,578900
866,95776,26,72,98,74,72,244,10.6557377,29.50819672,40.16393443,30.32786885,29.50819672,429900
867,95817,27,78,105,114,168,387,6.976744186,20.15503876,27.13178295,29.45736434,43.41085271,374200
868,95820,24,90,114,158,178,450,5.333333333,20,25.33333333,35.11111111,39.55555556,317700
869,95821,97,54,151,45,125,321,30.21806854,16.82242991,47.04049844,14.01869159,38.94080997,374500
870,95823,194,546,740,1017,2111,3868,5.015511892,14.11582213,19.13133402,26.2926577,54.57600827,285600
871,95824,1,0,1,6,5,12,8.333333333,0,8.333333333,50,41.66666667,243800
872,95825,1,1,2,3,41,46,2.173913043,2.173913043,4.347826087,6.52173913,89.13043478,331300
873,95826,13,36,49,72,128,249,5.220883534,14.45783133,19.67871486,28.91566265,51.40562249,349300
874,95828,238,479,717,958,2048,3723,6.392694064,12.86596831,19.25866237,25.73193661,55.00940102,309800
875,95829,465,553,1018,613,689,2320,20.04310345,23.8362069,43.87931034,26.42241379,29.69827586,429800
876,95831,35,71,106,138,251,495,7.070707071,14.34343434,21.41414141,27.87878788,50.70707071,485300
877,95832,27,47,74,78,100,252,10.71428571,18.65079365,29.36507937,30.95238095,39.68253968,319400
878,95833,9,9,18,15,43,76,11.84210526,11.84210526,23.68421053,19.73684211,56.57894737,349900
879,95834,39,76,115,87,148,350,11.14285714,21.71428571,32.85714286,24.85714286,42.28571429,415800
880,95835,86,119,205,149,170,524,16.41221374,22.70992366,39.1221374,28.4351145,32.44274809,452000
881,95838,6,22,28,58,162,248,2.419354839,8.870967742,11.29032258,23.38709677,65.32258065,276000
882,95843,329,508,837,669,714,2220,14.81981982,22.88288288,37.7027027,30.13513514,32.16216216,361900
883,95864,55,96,151,107,157,415,13.25301205,23.13253012,36.38554217,25.78313253,37.8313253,643200
884,95901,112,268,380,695,1377,2452,4.567699837,10.92985318,15.49755302,28.34420881,56.15823817,269300
885,95914,2,6,8,26,29,63,3.174603175,9.523809524,12.6984127,41.26984127,46.03174603,306900
886,95917,0,2,2,7,38,47,0,4.255319149,4.255319149,14.89361702,80.85106383,275000
887,95918,9,20,29,32,19,80,11.25,25,36.25,40,23.75,532700
888,95922,0,5,5,13,6,24,0,20.83333333,20.83333333,54.16666667,25,266200
889,95926,179,279,458,309,388,1155,15.4978355,24.15584416,39.65367965,26.75324675,33.59307359,370500
890,95928,162,282,444,339,335,1118,14.490161,25.2236136,39.7137746,30.32200358,29.96422182,388800
891,95932,54,98,152,201,326,679,7.95287187,14.43298969,22.38586156,29.60235641,48.01178203,285200
892,95938,70,126,196,143,154,493,14.19878296,25.55780933,39.75659229,29.00608519,31.23732252,477700
893,95939,1,2,3,7,10,20,5,10,15,35,50,138100
894,95942,11,12,23,24,19,66,16.66666667,18.18181818,34.84848485,36.36363636,28.78787879,392300
895,95945,100,197,297,329,399,1025,9.756097561,19.2195122,28.97560976,32.09756098,38.92682927,391400
896,95946,29,69,98,114,102,314,9.23566879,21.97452229,31.21019108,36.30573248,32.48407643,443600
897,95947,0,5,5,7,20,32,0,15.625,15.625,21.875,62.5,240100
898,95948,112,254,366,369,412,1147,9.764603313,22.14472537,31.90932868,32.17088056,35.91979076,260600
899,95949,106,182,288,269,272,829,12.78648975,21.95416164,34.74065139,32.44873341,32.8106152,448500
900,95951,10,25,35,98,189,322,3.105590062,7.763975155,10.86956522,30.43478261,58.69565217,240300
901,95953,20,38,58,68,126,252,7.936507937,15.07936508,23.01587302,26.98412698,50,276300
902,95954,0,3,3,2,22,27,0,11.11111111,11.11111111,7.407407407,81.48148148,194500
903,95957,0,2,2,18,27,47,0,4.255319149,4.255319149,38.29787234,57.44680851,278300
904,95959,107,126,233,185,155,573,18.67364747,21.9895288,40.66317627,32.28621291,27.05061082,519400
905,95961,40,190,230,470,1297,1997,2.003004507,9.514271407,11.51727591,23.53530295,64.94742113,292400
906,95962,1,3,4,17,39,60,1.666666667,5,6.666666667,28.33333333,65,297500
907,95963,75,149,224,347,765,1336,5.613772455,11.15269461,16.76646707,25.97305389,57.26047904,278200
908,95965,61,157,218,340,669,1227,4.971475143,12.79543602,17.76691117,27.70986145,54.52322738,216400
909,95966,10,41,51,62,149,262,3.816793893,15.64885496,19.46564885,23.66412214,56.87022901,244400
910,95969,19,48,67,78,123,268,7.089552239,17.91044776,25,29.10447761,45.89552239,300000
911,95970,3,9,12,13,43,68,4.411764706,13.23529412,17.64705882,19.11764706,63.23529412,450000
912,95971,33,45,78,102,109,289,11.41868512,15.57093426,26.98961938,35.29411765,37.71626298,266100
913,95973,15,38,53,31,29,113,13.27433628,33.62831858,46.90265487,27.43362832,25.66371681,402600
914,95979,0,3,3,4,10,17,0,17.64705882,17.64705882,23.52941176,58.82352941,250000
915,95982,28,75,103,119,188,410,6.829268293,18.29268293,25.12195122,29.02439024,45.85365854,292700
916,95988,38,98,136,221,380,737,5.156037992,13.29715061,18.4531886,29.98643148,51.56037992,244100
917,95991,112,114,226,198,360,784,14.28571429,14.54081633,28.82653061,25.25510204,45.91836735,297900
918,95993,92,140,232,164,211,607,15.15650741,23.06425041,38.22075783,27.01812191,34.76112026,353700
919,96001,549,631,1180,710,707,2597,21.13977667,24.29726608,45.43704274,27.33923758,27.22371968,319700
920,96002,263,396,659,682,850,2191,12.0036513,18.07393884,30.07759014,31.12733911,38.79507074,280900
921,96003,304,558,862,710,771,2343,12.97481861,23.815621,36.79043961,30.3030303,32.90653009,299600
922,96007,100,226,326,356,626,1308,7.645259939,17.27828746,24.9235474,27.21712538,47.85932722,235900
923,96008,35,52,87,58,62,207,16.90821256,25.12077295,42.02898551,28.01932367,29.95169082,197700
924,96009,3,0,3,17,37,57,5.263157895,0,5.263157895,29.8245614,64.9122807,277800
925,96011,1,2,3,2,6,11,9.090909091,18.18181818,27.27272727,18.18181818,54.54545455,115200
926,96013,13,40,53,85,106,244,5.327868852,16.39344262,21.72131148,34.83606557,43.44262295,169500
927,96017,2,8,10,6,19,35,5.714285714,22.85714286,28.57142857,17.14285714,54.28571429,258300
928,96019,57,116,173,181,225,579,9.844559585,20.03454231,29.8791019,31.26079447,38.86010363,219700
929,96020,5,4,9,17,26,52,9.615384615,7.692307692,17.30769231,32.69230769,50,229200
930,96021,117,210,327,456,867,1650,7.090909091,12.72727273,19.81818182,27.63636364,52.54545455,212900
931,96022,223,362,585,444,463,1492,14.9463807,24.26273458,39.20911528,29.75871314,31.03217158,263300
932,96023,1,0,1,4,12,17,5.882352941,0,5.882352941,23.52941176,70.58823529,120300
933,96024,45,33,78,20,11,109,41.28440367,30.27522936,71.55963303,18.34862385,10.09174312,278800
934,96025,2,4,6,12,31,49,4.081632653,8.163265306,12.24489796,24.48979592,63.26530612,232200
935,96027,6,21,27,41,37,105,5.714285714,20,25.71428571,39.04761905,35.23809524,240800
936,96028,9,34,43,51,56,150,6,22.66666667,28.66666667,34,37.33333333,286100
937,96029,3,7,10,6,15,31,9.677419355,22.58064516,32.25806452,19.35483871,48.38709677,311500
938,96032,36,48,84,68,52,204,17.64705882,23.52941176,41.17647059,33.33333333,25.49019608,253400
939,96033,6,4,10,3,0,13,46.15384615,30.76923077,76.92307692,23.07692308,0,130000
940,96034,0,2,2,9,15,26,0,7.692307692,7.692307692,34.61538462,57.69230769,305300
941,96038,22,38,60,38,28,126,17.46031746,30.15873016,47.61904762,30.15873016,22.22222222,213900
942,96039,4,10,14,9,28,51,7.843137255,19.60784314,27.45098039,17.64705882,54.90196078,143800
943,96041,35,45,80,43,28,151,23.17880795,29.8013245,52.98013245,28.47682119,18.54304636,310100
944,96044,0,4,4,5,22,31,0,12.90322581,12.90322581,16.12903226,70.96774194,177100
945,96047,1,6,7,15,9,31,3.225806452,19.35483871,22.58064516,48.38709677,29.03225806,367600
946,96048,12,19,31,12,5,48,25,39.58333333,64.58333333,25,10.41666667,330600
947,96052,2,8,10,8,20,38,5.263157895,21.05263158,26.31578947,21.05263158,52.63157895,282500
948,96055,60,91,151,112,159,422,14.21800948,21.56398104,35.78199052,26.54028436,37.67772512,229300
949,96056,20,21,41,28,23,92,21.73913043,22.82608696,44.56521739,30.43478261,25,266500
950,96057,4,7,11,15,19,45,8.888888889,15.55555556,24.44444444,33.33333333,42.22222222,237500
951,96062,51,45,96,44,17,157,32.48407643,28.66242038,61.14649682,28.02547771,10.82802548,325000
952,96064,18,70,88,85,131,304,5.921052632,23.02631579,28.94736842,27.96052632,43.09210526,199100
953,96067,46,71,117,114,105,336,13.69047619,21.13095238,34.82142857,33.92857143,31.25,320300
954,96069,1,6,7,12,11,30,3.333333333,20,23.33333333,40,36.66666667,327000
955,96073,140,160,300,155,133,588,23.80952381,27.21088435,51.02040816,26.36054422,22.61904762,451900
956,96080,183,363,546,634,1145,2325,7.870967742,15.61290323,23.48387097,27.2688172,49.24731183,250400
957,96087,5,14,19,20,26,65,7.692307692,21.53846154,29.23076923,30.76923077,40,334500
958,96091,3,2,5,4,4,13,23.07692308,15.38461538,38.46153846,30.76923077,30.76923077,321300
959,96092,5,17,22,16,16,54,9.259259259,31.48148148,40.74074074,29.62962963,29.62962963,275000
960,96093,32,46,78,57,95,230,13.91304348,20,33.91304348,24.7826087,41.30434783,298300
961,96094,21,35,56,42,64,162,12.96296296,21.60493827,34.56790123,25.92592593,39.50617284,248600
962,96097,36,107,143,208,373,724,4.972375691,14.77900552,19.75138122,28.72928177,51.51933702,190300
963,96101,34,63,97,134,188,419,8.114558473,15.03579952,23.150358,31.98090692,44.86873508,145900
964,96104,9,16,25,17,24,66,13.63636364,24.24242424,37.87878788,25.75757576,36.36363636,174400
965,96107,12,20,32,24,27,83,14.45783133,24.09638554,38.55421687,28.91566265,32.53012048,245800
966,96109,8,23,31,50,84,165,4.848484848,13.93939394,18.78787879,30.3030303,50.90909091,186400
967,96114,7,37,44,71,103,218,3.211009174,16.97247706,20.18348624,32.56880734,47.24770642,295100
968,96118,6,8,14,17,18,49,12.24489796,16.32653061,28.57142857,34.69387755,36.73469388,215000
969,96120,7,4,11,9,15,35,20,11.42857143,31.42857143,25.71428571,42.85714286,375300
970,96122,4,25,29,37,58,124,3.225806452,20.16129032,23.38709677,29.83870968,46.77419355,198000
971,96130,117,201,318,340,521,1179,9.923664122,17.04834606,26.97201018,28.8379983,44.18999152,218100
972,96134,1,22,23,57,123,203,0.492610837,10.83743842,11.33004926,28.07881773,60.591133,130100
973,96137,3,9,12,34,45,91,3.296703297,9.89010989,13.18681319,37.36263736,49.45054945,236300
974,96143,14,28,42,23,40,105,13.33333333,26.66666667,40,21.9047619,38.0952381,542100
975,96145,114,141,255,164,182,601,18.96838602,23.4608985,42.42928453,27.28785358,30.2828619,785700
976,96146,77,28,105,17,2,124,62.09677419,22.58064516,84.67741935,13.70967742,1.612903226,1203900
977,96161,293,343,636,346,368,1350,21.7037037,25.40740741,47.11111111,25.62962963,27.25925926,653600
},,,,,,,,,,,,,